//※필터링 때문에 변경된 문자열을 등록하는 경우에는 ♞표시.

//※ABAB형 부사는 ABAB 등록하고, ABABAB까지 등록해야 한다.

//█████████████████████████████████████████████████████████████████████████████
// 4.감동사, 인사 등 :
//█████████████████████████████████████████████████████████████████████████████

//#.상용어구로 등록 (감)
//▀▀▀▀▀▀▀▀▀▀▀▀▀▀▀▀▀▀▀▀▀▀▀▀▀▀▀▀▀▀▀▀▀▀▀▀▀▀▀▀▀▀▀▀▀▀▀▀▀▀▀▀▀▀▀▀▀▀▀▀▀▀▀▀▀▀▀▀▀▀▀▀▀▀▀▀▀
//こんなので	이런 것으로	0	//** こんなのです。こんなのですね。
あおむけに	위를 향해	0
あてどもなく	정처없이	0	//校内をあてどもなくうろつき、
あと一息	이제 한 고비	1
あの人はあの人で	그 사람은 그 사람대로	0
あるのかないのか	있는 것인가 없는 것인가	1
あるものですからね	있으니까요	0
あるんだかないのか	있는건지 없는건지	0	//♞あるんだかないんだか。
いいか悪か	좋은가 나쁜가	0
いかがかね	어떨까요	0
いか程ですか	얼마 정도입니까	0	//お代はいかほどですか。
いか程ですかね	얼마 정도일까요	0	//お代はいかほどですかね。
いざとなれば	여차하면	0
いずれがいずれに	어느쪽이 어느쪽에게	0
いずれがいずれの	어느쪽이 어느쪽의	0
いただきとうございます	주시기를 원합니다	0
イチかバチか	흥하든 망하든	0
いつだってでも	언제라도	0
いつになったら	언제쯤이면	0
いやというほど	싫다고 할만큼	0	//彼女が頑固であることは今までの付き合いでいやというほど分かっている。
うらやまけしからん	부러워서 참을 수 없음	0
おかまいなしに	상관치 않고	0
おしゃべりでも	수다라도	0	//おしゃべりでもしてる。
おやすみなさい	잘 자요	0
お見知りおきを	알아두시를	0
お気になさらずに	신경쓰지 마시도록	0
お気遣いなく	사양 않고	0
お気遣い無く	사양 않고	0
お待ちなさい	기다리세요	0
お渡しいたしました	인도했습니다	0
お渡しいたします	인도합니다	0
お忘れのないように	잊지 않도록	0
お腹すいたら	배 고프면	0
お付き下さい	앉으세요	0
お付き下さいませ	앉아주십시오	1
お好きなように	좋을대로	0	//お好きなようにするといい。
かくなるうえは	이렇게 된 바에는	0
かくなる上は	이렇게 된 바에는	0
かしこまりましてございました	잘 알았습니다	0
かしこまりましてございます	잘 알겠습니다	0
かたじけのうござる	황송합니다	0
かまいなしに	상관치 않고	0
かまいもせず	상관도 하지 않고	0	//そんな俺にかまいもせずに
かまいもせずに	상관도 하지 않고	0
かまいもなしに	상관도 않고	0
かんがみるに	비추어 보건데	0
かんがみるには	비추어 보려면	0
こういうなら	이렇다면	0
ここぞとばかり	이때라는 듯이	0
ここですね	여기군요	0
ここらへんに	이 근처에	0
この先に	이 앞에	0
この歳で	이 나이에	0
これまで	이것까지	0	//おそらくこれまでだ。
こんなだけど	이런 것이지만	0
こんなために	이 때문에	0
こんなのが	이런 것이	0	//こんなのがイイなんて、
こんなのに	이런 것에	0
こんなのも	이런 것도	0
こんなのを	이런 것을	0
ご機嫌斜め	심기 불편함	0
さもありなん	그럴 것이다	0	//彼なら然も有りなんだ
さもありなんだ	그럴 것이다	0	//彼なら然も有りなんだ
さも有りなん	그럴 것이다	0	//彼なら然も有りなんだ
さも有りなんだ	그럴 것이다	0	//彼なら然も有りなんだ
しかしだな	하지만 말이지	0
したりとばかり	잘 됐다는 듯	0	//鳥羽院はしたりとばかり笑う
してようがしていないだろうが	하고 있든 하고 있지 않든	0
しれっとした	천연덕스러운	0	//しれっとした顔
スキアリ	빈틈 있음	0
スキアリッ	빈틈 있음	0
すこしばかり	아주 조금만	0
そういうなら	그렇다면	0
そうたいした	그렇게 대단한	0	//そうたいしたことじゃないだろ。
そうだったな	그랬구나	0	//そ、そうだったな。
そうだったなら	그랬다면	0
そうであるような	그럴 것 같은	0
そうなんだわ	그래요	0
そこですね	거기군요	0
そこはかとない	왠지 모를	0	//そこはかとない不安を感じながらも
そこはかとなく	공연스레	0
そのあまりにも	그 너무도	0	//そのあまりにも意外な中身
そのいずれ	그 어느쪽	0
そのために	그 때문에	0
そのためには	그걸 위해서는	0
そのまえに	그 전에	0
そのまさかよ	그 설마야	0
そのわりには	그런 것 치고는	0
それでいて	그러면서	0
それでいながら	그러면서	0
それですね	그것이군요	0
それでなかったら	그것이 아니라면	0
それでなくても	그렇지 않아도	0
それならそうと	그럼 그렇다고	0
それならそれで	그렇다면 그걸로	0
それにしては	그런 것 치고는	0
それについては	그것에 대해서는	0
それはそれで	그건 그걸로	0
それはそれとして	그건 그걸로하고	0
それはそれは	이거 정말	0	//ご幼少のリシア様は、それはそれは可愛らしゅうございました
それはでも	그건 그렇지만	0
そんなだけど	그런 것이지만	0
そんなために	그 때문에	0
そんな感じ、	그런 느낌,	0
ただいまより	지금보다	0
だめだわ	안 되요	0
ついうっかり	무심결에	0
ついでだから	하는 김이니까	0
できることとできないこと	할 수 있는 것과 할 수 없는 것	1
どいつもコイツ梦彼も	이놈도 저놈도	0	//♞どいつもこいつも
どうしたのかね	무슨 일인걸까요	0	//ど、どうしたのかね
どうしてもこうしても	이렇게도 저렇게도	0
どうでしょうね	어떨까요	0
どうとっても	어떻게 봐도	0	//女性には、どこをどうとっても可愛さがあるのだから
どうなのだと	어떻다고	0
どうなんだと	어떻다고	0
どうもこうも	이렇지도 저렇지도	0
どうもこーも	이렇지도 저렇지도	0	//♞
どこかしらで	어딘가에서	0
どこもかしこも	여기도 저기도	0
ところかまわず	어디든 가리지 않고	0
どんなにか	얼마나	0
なにからなにまで	무엇부터 무엇까지	0	//すみません、なにからなにまで、すっかりお世話に　なってしまって
なにもかも	이것도 저것도	0
なんてこった	무슨 일이다	0
なんてったって	뭐라고 해도	0
なんとでも	뭐라고라도	0
なんにしても	어쨌든	0
なんべんとなく	몇 번씩이나	0	//なんべんとなく 往復した
なんやかんや	이러니 저러니	0
のっけから	처음부터	0
バレバレ	들키고 들키고	1
ふってわいた	느닷없이 솟아나온	0
へったくれ	뭣	0	//配慮もへったくれも
ほどなくして	얼마 지나지 않아	0
まぎれもなく	틀림없이	0	//まぎれもなく、ゆき姉の声だった。
まぎれも無く	틀림없이	0	//まぎれもなく、ゆき姉の声だった。
めっそうもございません	터무니없습니다	0
もういっかい	다시 한 번	0
もう一段階	더 한 단계	0
やむにやまれず	어찌할 수 없이	0
やむをえず	할 수 없이	0	//やむをえず、音美は仔猫がいる枝の先の方へと移動しはじめた。의 앞에와 이동
ゆっくりとした	느긋한	0
よりにもよって	하필이면	0
わずかずつ	조금씩	0
わずかばかり	아주 조금만	0
稼ぐに	돈벌이에	0
減るもんじゃないし	닳는 것도 아니고	0
減るもんじゃなし	닳는 것도 아니고	0
強から弱へ	강에서 약으로	0
強から中へ	강에서 중으로	0
降ってわいた	느닷없이 솟아나온	0
降って湧いた	느닷없이 솟아나온	0
開口一番	입을 열자마자	0
見ざる聞かざる	묻지도 따지지도 않는	0
見下げ果てた	경멸스러운	0
謙遜なさる必要	겸손하실 필요	0
固いこといいっこなし	딱딱한 이야기 하지 않음	0
高い高いを	높이높이를	0
矯めつすがめつ	이모저모	0
矯めつ眇めつ	이모저모	0
僅かずつ	조금씩	0
僅かながら	얼마 안 되지만	0
僅かばかり	아주 조금만	0
機嫌ななめ	심기 불편함	0
能力の限り	능력이 닿는 한	0
能力の限りに	능력이 닿는 한	0
当然のごとく	당연하다는 듯이	0
待てど暮らせど	아무리 기다려도	0
大なり小なり	크든 작든	0
毒を食えば皿まで	독을 먹으려면 접시까지	0
同じのを	같은 것을	0
頭かくして	머리 숨기고	0
頭が割れるほど	머리가 쪼개질 정도	1
良くも悪くも	좋아도 싫어도	0
連れ立って行けば	같이 가면	0	//連れ立って行けば
滅相もございません	터무니없습니다	0
毛頭ございません	털끝만큼도 없습니다	0
無くにしもあらず	전혀 없는 것도 아니다	0
物足りず	뭔가 부족해	0
物足りずに	뭔가 부족해	0
弥が上にも	더욱 더	0
背に腹は	등이 배는	0
背に腹を	등이 배를	0
百聞は一見にしかず	백문이 불여일견	0
否が上にも	좋든 싫든	0
否が応でも	좋든 싫든	0
不覚にも	무의식중에	0
思う壺	예상하는 바	0
斯くなるうえは	이렇게 된 바에는	0
斯くなる上は	이렇게 된 바에는	0
私じゃなくて	내가 아니고	0	//あたしじゃなくて彼だ。**お前じゃなくて彼だ。
私じゃなくても	내가 아니라도	0
私としたことが	이 내가	0
私ばっかり	나 혼자만	1
三日にあげず	매일같이	0
上げたり下げたり	치켜올렸다가 깎아내렸다가	0
選り取り見取り	마음대로 골라잡기	1
少しばかり	아주 조금만	0
所嫌わず	어디든 가리지 않고	0
誰か人が	누군가 사람이	0
是か非か	옳은지 그른지	0
是が非でも	반드시	0
是が非にでも	반드시	0
信じようが信じまいが	믿든 믿지 않든	0
身よりを	친척을	0	//オレは子供の頃に身よりを失い、
心の持ちよう	마음가짐	0
案じ召されるな	염려 마시길	0
弱から強へ	약에서 강으로	0
弱から中へ	약에서 중으로	0
若しかしたら	어쩌면	0
言うに事欠いて	할 말이 따로있지	0
然もありなん	그럴 것이다	0	//彼なら然も有りなんだ
然もありなんだ	그럴 것이다	0	//彼なら然も有りなんだ
然も有りなん	그럴 것이다	0	//彼なら然も有りなんだ
然も有りなんだ	그럴 것이다	0	//彼なら然も有りなんだ
然らなければ	그렇지 않으면	0	//然らずば (예비1에서 然らなければ로 바뀜)
然様でございました	그러했습니다	0
然様でございます	그렇습니다	0
迎えに来い	맞이하러 와	0
偽らざる	속임없는	0
已むにやまれず	어찌할 수 없이	0	//(やむにやまれず)
已むに已まれず	어찌할 수 없이	0	//(やむにやまれず)
人を呪わば穴二つ	남을 저주하면 구덩이 2개	0
一癖も二癖も	한 성깔도 두 성깔도	0
入って来い	들어와	0
子供じみた	아이 같은	0
自分のことのように	자신의 일처럼	0
前見て	앞을 보고	0
蝶よ花よと	금지옥엽	0
程なくして	얼마 지나지 않아	0
精も根も	정력도 근성도	0
早い所	빨리	0
早速だが	갑작스럽지만	0
中から強へ	중에서 강으로	0
中から弱へ	중에서 약으로	0
持ってだけ	가지고만	0
千里のネタも一歩から	천리길도 한걸음부터	0
草々を	수풀을	0
出来うる限	할 수 있는 한	0
出来得る限	할 수 있는 한	0
致し方ございません	어쩔 수 없습니다	0
他ならず	다름 아니고	0	//クリミア半島のロシア編入は侵略に他ならず、いかなる正当性もない。
痛みゆえの	아프기 때문의	0
平たくいえば	쉽게 말하면	0
平たく言えば	쉽게 말하면	0
何たって	뭐라해도	0
何たっても	뭐라해도	0	//何たっても俺たちは根無し草だからな
何てったって	뭐라고 해도	0
何もかも	이것도 저것도	0
何を差し置いても	만사 제쳐두더라도	0
何層にも	몇겹이나	0
何遍となく	몇 번씩이나	0	//なんべんとなく 往復した
幸い事もあろうに	하필이면	0
嘘おっしゃい	거짓말 하지 말아요	0
好きってだけ	좋아한다는 뿐	0
好きなように	좋을대로	0	//お好きなようにするといい。
好むと好まざるとに	좋아하든 좋아하지 않든지	0
それではまた	그럼 또	0
蜘蛛の子を散らすように	새끼 거미가 흩어지듯이	0
蜘蛛の子を散らすような	새끼 거미가 흩어지듯한	0
蜘蛛の子を散らすよう	새끼 거미가 흩어지듯	0
底知れない	바닥을 알 수 없는	0
いいですわね	좋네요	0
どっこいしょ	으랏차	0
ぴんぽーん	띵-동	0
コトワル	거절한다	0
やるかやんないか	할까 말까	0	//うちの学校って、部活やるかやんないか自由だから
どんな手を使っても	무슨 수를 써서라도	0
未見の	보지 못한	0	//未見の俺にも直ぐにそれだと判った。
向かう先に	향하는 앞에	0	//向かう先には。
理にも至れない身	이치도 깨우치지 못한 몸	1	VBp	//신체부위 :
面白半分に	반쯤 재미로	0	//誰かが面白半分に開けたらどうする
おもしろ半分に	반쯤 재미로	0
行動ありきと宣伝ありき	행동이 있어야 선전이 있다	0	//
穿った見方	핵심을 찌르는 견해	1
するので精一杯	하는 것으로 힘껏	1	//対処するので精一杯だ
どこかしらに	어디일까에	0	//どこかしらには。
上手くいったら	잘하면	0	//上手くいったら英雄で、最悪は廃人。
ふたりとも	두사람 모두	0	//ふたりとも家にいるはずだった。
あれほどまで	저 정도까지	0
あげようんだから	주자는 것이니까	0	//いってあげようんだからね
いたらいたで	있으면 있는걸로	0	//彼女がいなければいないで寂しいのに、いたらいたで煩わしく思えるのは何故なのですか
いち、に、さん、よん	하나, 둘, 셋, 넷	1
いち、に、さん	하나, 둘, 셋	1
位置について	자리에 위치해	0
お前にゃ	너에게는	0	//お前にゃ、まだ早い！
完膚なきまで	멀쩡한 곳이 없도록까지	0	//コレクションを完膚なきまでに消されてしまった
見ようによっては	보기에 따라서는	0
ご存知のとおり	아시는대로	0
ときめきの	두근거림의	0	//あの子を見た時に感じたときめきの正体を知りたい。
私どものように	우리들 같이	0
私どものような	우리들 같은	0
ああやって	저렇게 해	0	//先輩とああやって遊んでるのが楽しかったんだなって……
ああなって	저렇게 되어	0
肉を切らせて骨を断つ	살을 주고 뼈를 취한다	0
落ちつきを	안정을	0
出会い頭に	만나자마자	0	//出会い頭に抱きしめる。
出会い頭の	만나자마자의	0
あついから	더우니까	0	//あついからプール行こうぜ
あってなきがごとし	없는 것이나 마찬가지	0	//あってなきがごとしですよ
昔のことすぎて	너무 옛 일이라	0	//もう、昔のことすぎて覚えてない。
手元が狂って	손이 빗나가	0	//手元が狂ってそのまま胸を掴んでしまう。
我が物顔で	자기 것인양	0
我が物顔に	자기 것인양	0	//我が物顔にふるまう
あとからあとから	연달아서	0
後から後から	연달아서	0
煮るなり焼くなり	구워먹든 삶아먹든	0
清き流れに魚棲まず	맑은 물에는 고기가 살지 못한다	0
万事休す	만사 끝나버림	1	//万事休すか
男女七歳にしてお席を同じうせず	남녀칠세부동석	0	//♞
善は急げ	좋은 일은 서두른다	0	//じゃあ、善は急げってことで私達そろそろ出發するわ。
王様の耳はロバの耳	임금님 귀는 당나귀 귀	1
ふんだりけったり	엎친데 덮친격	1
なんぴとたりとも	몇 사람이라도	1
高みの見物	강 건너 불구경	1
金の切れ目が縁の切れ目	돈이 떨어지면 인연도 끊어짐	1
急がば回れ	급할수록 돌아가라	0
お茶の子さいさい	누워서 떡먹기	0
どっちかから	어디인가부터	0	//せめてどっちかから順番にしゃべれよ！
その前で	그 앞에서	0
やり合った方	서로 하는 편	1	//当事者同士がやり合った方が上手くいくよな。
行きと違って	갈 때와 달리	0
行きとは違って	갈 때와는 달리	0
行きと違う	갈 때와 다른	0
行きとは違う	갈 때와는 다른	0
その歳で	그 나이에	0	//その歳であんなもの見て
違くて	달라	0
再び眠りに	다시 잠에	0	//小路は再び眠りに落ちる。
あったかくて	따듯하고	0	//あったかくて柔らかくて……そんですごくいい匂い！
身近な	가까운	0
身近で	가까이에서	0
知るよしも	알 길도	0	//その時の俺は、知るよしもなかったのである。
ばなれした	익숙해진	0	//しかし、凛とした佇まいからは、どこか日本人ばなれしたものを感じる。
取り得のない	장점이 없는	0
これといって取り得のない	이렇다 할 장점이 없는	0
藪から棒	아닌 밤중에 홍두깨	1
あまり悩ませず	너무 고민하지 않고	0
あまり悩ませずに	너무 고민하지 않고	0
あとさっきの	그리고 조금 전의	0	//あとさっきの話だけどな
向かいがてら	향하는 김에	0	//さっきは向かいがてら説明するって言ってなかったか？
ごきげんな様子	기분 좋은 모습	1
まかして置いて	맡겨 둬	0	//♞まかしといて！
絢爛なる	현란한	0	//絢爛なる円舞曲を踊ることができるだろうと。
そういうところ	그러한 곳	0
たくらみも	계획도	0	//お前のたくらみもここまでだ。
先陣切って	앞장서	0	//先陣切って華々しく死ねってのかい？
壁に耳あり障子に目あり	벽엔 귀가 있고 문엔 눈이 있다	0
めでたしめでたし	경사로다 경사로다	0
一応の	일단의	1
顧問たって	고문해도	0
突き当りまで	막다른 곳까지	0	//突き当りまで来ると、
その名に	그 이름에	0	//その名に恥じぬ宝を持っておる
顔せんでも	얼굴 하지 않아도	0	//そんなに悲しい顔せんでも
表情せんでも	표정 하지 않아도	0
持ちなよ	가져요	0	//自身を持ちなよ
偶然による	우연에 의한	0	//単なる偶然による不運もやけに多い
関東勢百万と候え	관동에 백만 무사가 있다하나	0	//関東勢百万と候え、男はひとりもなく候
男はひとりもなく候	사내는 하나도 없구나	0	//関東勢百万と候え、男はひとりもなく候
何時も通り	언제나처럼	0
こんな感じで	이런 느낌으로	0	//こんな感じです
ものがものだけに	물건이 물건인만큼	0
二言目には	말을 꺼냈다 하면	0	//どいつもこいつも二言目には人を暇呼ばわりしやがって。
お前がいーなら	너가 좋다면	0	//まぁーお前がいーならそれでいーけどな
口先だけ	말로만	0	//どうせ口先だけだろ？
ふりだしに	출발점에	0	//ふりだしに戻る
揃いも揃って	모두가 다	0	//揃いも揃っておおらかなのか？
そろいもそろって	모두가 다	0	//揃いも揃っておおらかなのか？
良薬口に苦し	좋은 약 입에 쓰다	0
おそらくですけど	아마도입니다만	0
唯一つの	유일의	0
虎穴にいらずんば	호랑이 굴에 들어가지 않으면	0
どれ程	어느 정도	0	//どれ程体を鍛えようと、
起き抜け	일어나자마자	1
起き抜けに	일어나자마자	0
仇なす	적대하는	0	//マスターに仇なす者は全て……。
油断は大敵	방심은 금물	1	//まだ油断は大敵だよ
死せる	죽은	0	//死せる戦士の館ヴァルハラに勇者達の魂を集める…。
素知らない	모르는체 하는	0	//♞素知らぬ
わずかも	조금도	0	//力任せに叩きつけられる腰はわずかも速度を緩めない。
我知らず	자기도 모르게	0
わずかながら	조금이지만	0	//小路の声のトーンにわずかながら快感の色が混じってきた。
それしきの	그까짓	0	//それしきのことで引き下がったりはしません！
これしきの	이까짓	0	//
あること無いこと	있는 일 없는 일	1
あることないこと	있는 일 없는 일	1
有ること無いこと	있는 일 없는 일	1
組んず解れつ	엎치락 뒤치락	1
将又	혹은	0
はたまた	혹은	0
はるか昔の	아득한 옛날의	0
はるか昔から	아득한 옛날부터	0
しからずんば	그렇지 않으면	0
ありきなくらい	있었기에 라고 할 정도	1	//この方ありきなくらいお世話になってるママ友さんと。失敗ありきなくらいの気持ちで作ればいいんじゃないかなぁっと。
少しだけど	조금이지만	0	//少しだけど口が動いてるよ！？
あるのだか無いのだが	있는 것인가 없는 것인가	0
おいわいの	축하의	0	//『おいわいの日』
それからでも	그로부터라도	0	//話はそれからでも遅くないでしょ。
ひとことふたこと	한 마디 두 마디	0
でこぴん	딱밤	1	//でこぴんすることないだろ！
年がら年中	1년 내내	1	//毎日毎日、年がら年中、
おつかいを	심부름을	0	//おつかいを頼まれたんです
どういうのが	어떠한 것이	0	//ウィルってどういうのが目標なの？
どういうのも	어떠한 것도	0
どういうのを	어떠한 것을	0
我ながら	나로서도	0
我ながらも	나로서도	0
いたれりつくせり	극진함	1
いたれり尽くせり	극진함	1
いたれりつくせりの	극진한	0
いたれり尽くせりの	극진한	0
ひと癖もふた癖も	이런 성향도 저런 성향도	0
いちいち口に	하나 하나 입에	0	//いちいち口に出さなくてもいいだろ！？
兎にも角にも	어찌 되었든	0
おんぶにだっこ	업어주면 안아달라고 한다	1
負んぶに抱っこ	업어주면 안아달라고 한다	1
おんぶすればだっこ	업어주면 안아달라고 한다	1
負んぶすれば抱っこ	업어주면 안아달라고 한다	1
為り立ての	갓 되어 얼마 안 된	0	//中学生に為り立てのころ
善かれと	잘 되라고	0	//善かれと思ってしたことさ。善かれと祈る。
数知れず	헤아릴 수 없고	0
夜っぴて	밤새	0	//夜っぴて起きてたんならともかく。
どれもこれも	이것도 저것도	0	//どれもこれも……思い出せない。
くったくの無い	근심 없는	0	//少年はくったくの無い笑顔を見せる。
くったくのない	근심 없는	0	//少年はくったくの無い笑顔を見せる。
つり革を	손잡이를	0	//苛立ちを堪えるようにつり革を握り直すハヤト。
水をくみに	물을 길러	0	//おっちゃんは水をくみに行く。
元も子も	본전도 이자도	0	//元も子もない。
目を移らせずには	눈을 옮기지 않고는	0
目を移らせずに	눈을 옮기지 말고	0
目を移らせず	눈을 옮기지 못하고	0
寸でで	한끗 차이로	0
沿ぐわず	따르지 않고	0	//意に沿ぐわず秩序を乱す者は
如何にして	어떻게 해서	0
寸分足らずで	순식간에	0
いつもみたいに	언제나와 같이	0	//いつもみたいに皮肉で返す。
故に我有り	고로 나는 존재한다	0	//我思う、故に我有り
売り言葉に買い言葉	가는 말 고와야 오는 말도 곱다	0
王侯将相いずくんぞ種あらんや	왕후장상의 씨가 따로 있겠는가	0
随意に	뜻대로	0
働かざる者、食うべからず	일하지 않는 자, 먹지도 말라	0
手を変え品を変え	온갖 수단을 동원해	0
手を変え品を変えて	온갖 수단을 동원해	0
手を変え品を変えながら	온갖 수단을 동원하면서	0
窮鼠猫を噛む	궁지에 몰린 쥐 고양이를 문다	0
何処かしらに	어디인가에	0	//何処かしらにエラーが出る‥
久しぶりなまともな	오랜만의 착실한	0
感触がしたと同時	감촉이 든 것과 동시	1
見ざる言わざる聞かざる	보지도 말하지도 듣지도 않는다	0
言わざる聞かざる	말하지도 듣지도 않는다	0
百見は一聞にしかず	백문이 불여일견이다	0
私の分の	내 몫의	0	//私の分の魚も少しあげますね
物言えば唇寒し秋の風	말하자면 입은 재앙의 근원	1
焼け石に水	언 발에 오줌누기	1
知ってか知らずか	아는지 모르는지	0
過ぎたるは及ばざるが如し	지나친 것은 모자란 것과 같다	0
取らない狸の皮算用	잡지도 않은 너구리 가죽값 계산	1	//♞取らぬ狸の皮算用
おとがめなし	추궁하기 없음	1
すみからすみまで	처음부터 끝까지	0
露知らず	전혀 모르고	0	//もちろん当の本人はそんなことは露知らず。
体を張ったギャグ	몸을 던진 개그	1
照覧あれ	살피소서	0	//12本ものショートストーリーを照覧あれ！
御照覧あれ	살피소서	0
そんでもって	그러니까	0
言わずと知れた	말할 것도 없는	0
あーだこうだ	이렇다 저렇다	0	//♞あーだこーだ
あーだこうだと	이렇다 저렇다	0	//♞俺は表現に関してあーだこーだと悩んでいた。
有り合わで	마침 있는 것으로	0	//有り合わせ 의 오타인데 종종 나오는 모양
よってたかって	여럿이 모여서	0
寄ってたかって	여럿이 모여서	0
寄って集って	여럿이 모여서	0
願わくば	바라건데	0
ねがわくは	바라건데	0
出しぬけに	불쑥	0
あまりにもあんまりな	너무나도 너무한	0
あまりにもあまりな	너무나도 너무한	0
あまりにあまんりな	너무나 너무한	0
あまりにあまりな	너무나 너무한	0
ふつーそんな	보통 그런	0	//ふつーそんな聞き間違いする？
ふつーこんな	보통 이런	0	//ふつーこんな値段で買えないから
街外れの	거리 변두리의	0	//街外れのコンビニへ向かうだろう。
高慢ちきの	거만한	0	//あんな高慢ちきのミニマム星人
口開けの	개시의	0	//口開けの客
何気なしに	별 생각 없이	0	//ふと何気なしに窓の外に目をやる
ああだこうだ	이렇다 저렇다	0	//それは当人不在の場でああだこうだ言い合っていてもわからないだろう。
いいんだか悪いのか	좋은건지 나쁜건지	0	//♞いいんだか悪いんだか
そう急がずとも	그렇게 서두르지 않더라도	0
暗暗のうちに	암암리에	0
三遍回ってワンと鳴いて	세 바퀴 돌고 멍하고 짖어	0
三遍回ってワン	세 바퀴 돌고 멍	0
三べん回ってワンと鳴いて	세 바퀴 돌고 멍하고 짖어	0
三べん回ってワン	세 바퀴 돌고 멍	0
嘘か真か	거짓인가 진실인가	0
にっちもさっちも	이러지도 저러지도	0
二進も三進も	이러지도 저러지도	0
なんかなんだか	뭔가 무엇인가	0
何かなんだか	뭔가 무엇인가	0
人にして人を	사람이면서 사람을	0
はばかりながら	송구스럽습니다만	0
こちらとても	이쪽으로서도	0
あったればこそ	있었으니까	0	//その仕込みがあったればこその諧謔事。
やむ無し	어쩔 수 없음	0
止むを得ず	어쩔 수 없이	0
死して生あり生して死あり	죽음에 삶 있고 삶에 죽음 있다	0
死して十界生して十界	죽어서 10계 살아서 10계	0
死とは生なり生とは死なり	죽음은 삶이며 삶은 죽음이다	0
ありさえすれば	있기만 하면	0	//俺のものでありさえすれば
あろうがないだろうが	있든지 없든지	0	//こころがあろうがなかろうが、道具は道具。
定かならぬ	확실치 않은	0
曲がりなりにも	그럭저럭	0
どうにもこうにも	이렇게도 저렇게도	0
できたればこそ	가능했기 때문에야말로	0	//心持ちに余裕ができたればこそそんな思いも浮かぶのだ。
その割りに	그것치고	0
なぜかくも	왜 이처럼	0
何故かくも	왜 이처럼	0
覚めやらぬ	가시지 않은	0
覚めやらない	가시지 않은	0	//♞覚めやらぬ
覚め遣らぬ	가시지 않은	0
覚め遣らない	가시지 않은	0	//♞覚め遣らぬ
冷め遣らぬ	가시지 않은	0
冷め遣らない	가시지 않은	0	//♞冷め遣らぬ
冷めやらぬ	가시지 않은	0
冷めやらない	가시지 않은	0	//♞冷めやらぬ
ほっときゃ	냅두면	0
楽しからぬ	즐겁지 않은	0
否が応にも	좋든 싫든	0


//#.인사 ('감)
//▀▀▀▀▀▀▀▀▀▀▀▀▀▀▀▀▀▀▀▀▀▀▀▀▀▀▀▀▀▀▀▀▀▀▀▀▀▀▀▀▀▀▀▀▀▀▀▀▀▀▀▀▀▀▀▀▀▀▀▀▀▀▀▀▀▀▀▀▀▀▀▀▀▀▀▀▀
お待ち下さいませ	기다려 주십시오	0
少々お待ち下さいませ	잠시만 기다려 주십시오	0
ありがとうござっした	감사했습니다	0
ありがとうござっしたよ	감사했어요	0
アンディオス	아디오스	1
いっただきます	잘 먹겠습니다	0
いっただっきます	잘 먹겠습니다	0
おいしいございました	맛있었습니다	0
おはいりなさい	들어오세요	0
お見知り置き下さい	처음 뵙겠습니다	0
お待たせしました	오래 기다리셨습니다	0
お待たせでした	오래 기다리셨습니다	0
お待たせ致しました	오래 기다리셨습니다	0
お待ちどうさま	오래 기다리셨어요	0
お待ちどうさまでした	오래 기다리셨습니다	0
お待ちどうさん	오래 기다리셨죠	1
お待ちどう様	오래 기다리셨어요	0
お待ちどう様でした	오래 기다리셨습니다	0
お待ち申し上げておりました	기다리고 있었습니다	0
お待ち申し上げております	기다리고 있습니다	0
お待ち遠様でした	오래 기다리셨습니다	0
お逢いしとうございました	만나뵙고 싶었습니다	0
お逢いしとうございます	만나뵙고 싶습니다	0
お邪魔いたしました	실례했습니다	0
お邪魔いたします	실례합니다	0
お邪魔さま	실례해요	0
お入りなさい	들어오세요	0
お粗末様	변변치 못했어요	0
お粗末様でございました	변변치 못했습니다	0
お粗末様でした	변변치 못했습니다	0
お通り下さい	통과해 주세요	0
お疲れ様でございました	수고하셨습니다	0
お疲れ様でございます	수고하셨습니다	0
お下がりなさい	물러나세요	0
お下がり下さい	물러나 주세요	0
お会いしとうございました	만나뵙고 싶었습니다	0
お会いしとうございます	만나뵙고 싶습니다	0
お休み下さい	쉬세요	0
グッジョッブ	굿잡	1
グッドラック	굿럭	1
ごきげんうるわしゅう	평안하신지요	0
ごみんごみん	미안미안	0
ごめん下さい	실례합니다	0
コンニチワ	콘니치와	1
ご機嫌麗しいです	평안하십니까	0	//♞필터링전 : ご機嫌麗しゅうございます
ご機嫌麗しいですか	평안하십니까	0	//♞필터링전 : ご機嫌麗しゅうございます
ご機嫌麗しゅう	평안하신지요	0
ご愁傷様	참 안됐습니다	0	//(x)
サンキュッ	땡큐	1
サンクス	땡스	1
ばいばーい	바이바-이	1
ばいばい	바이바이	1
また明日ね	내일 봐요	0
わりぃ	미안	0
わりいぃ	미안	0
大丈夫でございました	괜찮았습니다	0
大丈夫でございます	괜찮습니다	0
謝謝	셰셰	1
申し訳在りません	죄송합니다	0
申し訳在りませんでした	죄송했습니다	0
畏まりました	알겠습니다	0
下がりなさい	물러나세요	0
下がり下さい	물러나 주세요	0
行って参ります	다녀 오겠습니다	0
頂戴致します	받겠습니다	0
頂戴致しました	받았습니다	0
いっらしゃいませ	어서 오세요	0
めんごめんご	안미안미	0
よろしくお願いしますわね	잘 부탁 드려요	0
入っていらっしゃい	들어오세요	0	//♞入ってらっしゃい
ごめんさい	미안해요	0
おめでとうさん	축하해요	0
ありがたい幸せにございます	성은이 망극하옵니다	0	//♞ありがたき幸せにございます
ありがたい幸せに	성은이 망극하게	0	//ありがたき幸せに存じまする
どうしたしまして	천만에요	0
ツァイツェン	짜이찌엔	0
お説ごもっとも	지당하신 의견입니다	0
成る程ごもっとも	과연 지당한 말씀입니다	0
成るほどごもっとも	과연 지당한 말씀입니다	0



//#.'감동사
//▀▀▀▀▀▀▀▀▀▀▀▀▀▀▀▀▀▀▀▀▀▀▀▀▀▀▀▀▀▀▀▀▀▀▀▀▀▀▀▀▀▀▀▀▀▀▀▀▀▀▀▀▀▀▀▀▀▀▀▀▀▀▀▀▀▀▀▀▀▀▀▀▀▀▀▀▀
あらあら	아라아라	0
いやはや	거참	0
おいたわしや	딱하다	0
おやおや	이런이런	0
おらおら	오라오라	0
こらこら	이봐이봐	0
さてさて	이것 참	0
そらそらっ	이봐이봣	0
そらっそらっ	자자	0
どれどれ	어디어디	0
うおっほん	우옷흠	0
おやまあ	이런	0
はいはーい	예예-	0
よーいどん	준비- 땅	0







//█████████████████████████████████████████████████████████████████████████████
// 5.체언 :
//█████████████████████████████████████████████████████████████████████████████
//호칭'명사
アーチャー	아쳐#N	1	VHn	//인간
アゲハチョウ	호랑나비#N	1	QAE	//곤충류
アサシン	어쌔신#N	1	VHn	//인간
アテ馬	들러리#N	1	VHn	//인간
アナル狂い	애널광#N	1	VHn	//인간
馬鹿者め	바보놈#N	1	VHn	//인간
あまえん坊	장난꾸러기#N	1	VHn	//인간
アヤカシ	요괴#N	1	VHn	//인간
アリクイ	개미핥기#N	1	QAA	//포유류
アルケミスト	알케미스트#N	1	VHn	//인간
あわてん坊	덜렁이#N	1	VHn	//인간
アンデッド	언데드#N	1	VHn	//인간
アンドロイド	안드로이드#N	1	VHn	//인간
イケメン	이케맨#N	1	VHn	//인간
いじめっ子	괴롭히는 아이#N	1	VHn	//인간
いじめっこ	괴롭히는 아이#N	1	VHn	//인간
いじめられっ子	괴롭혀지는 아이#N	1	VHn	//인간
苛められっこ	괴롭혀지는 아이#N	1	VHn	//인간
イモウト	여동생#N	1	VHn	//인간
インタビュアー	인터뷰어#N	1	VHn	//인간
ヴァイオリニスト	바이올리스트#N	1	VHn	//인간
ヴァンパイア	뱀파이어#N	1	VHn	//인간
ヴェアヴォルフ	웨어울프#N	1	VHn	//인간
ウッカリ者	멍청이	1	VHn	//인간
ウミネコ	괭이갈매기#N	1	VHn	//인간
ウリボウ	멧돼지#N	1	QAA	//포유류
ウルフハウンド	울프하운드#N	1	QAA	//포유류
エイリアン	에일리언#N	1	VHn	//인간
エゴイスト	에고이스트#N	1	VHn	//인간
エルフ	엘프#N	1	VHn	//인간
えろおやじ	에로아저씨#N	1	VHn	//인간
おうじさま	왕자님#N	1	VHn	//인간
オーガ	오거#N	1	VHn	//인간
オカマ	여장남자#N	1	VHn	//인간
おじちゃん	아저씨#N	1	VHn	//인간
おしゃべり屋	수다쟁이#N	1	VHn	//인간
おじ様	아저씨#N	1	VHn	//인간
オス犬	수캐#N	1	QAA	//포유류
オタク	오타쿠#N	1	VHn	//인간
オタンコナス	멍청이#N	1	VHn	//인간
おたんちん	멍청이#N	1	VHn	//인간
オチンポ狂い	자지광#N	1	VHn	//인간
オッサン	아저씨#N	1	VHn	//인간
おっちゃん	아저씨#N	1	VHn	//인간
おっとり屋	차분한 사람#N	1	VHn	//인간
オトウト	남동생#N	1	VHn	//인간
オトメ	아가씨#N	1	VHn	//인간
オナニスト	오나니스트#N	1	VHn	//인간
オナペット	오나펫#N	1	VHn	//인간
オニババ	오니바바#N	1	VHn	//인간
オネエサン	누나#N	1	VHn	//인간
おねぼう	잠꾸러기#N	1	VHn	//인간
おばかさん	바보씨#N	1	VHn	//인간
おばさま	아주머님#N	1	VHn	//인간
オバチャン	아줌마#N	1	VHn	//인간
オバちゃん	아줌마#N	1	VHn	//인간
おばば	할멈#N	1	VHn	//인간
オバン	아줌마#N	1	VHn	//인간
おば様	아주머님#N	1	VHn	//인간
オフクロ	어머니#N	1	VHn	//인간
おほしさま	별님#N	1	VHn	//인간
オマワリさん	순경#N	1	VHn	//인간
オヤジ	아저씨#N	1	VHn	//인간
オヤジィ	아저씨#N	1	VHn	//인간
オヤジさん	아저씨#N	1	VHn	//인간
おやっさん	아저씨#N	1	VHn	//인간
お茶目	장난꾸러기#N	1	VHn	//인간
お馬さん	말씨#N	1	QAA	//포유류
お母さん	어머니#N	1	VHn	//인간
お母ちゃん	엄마#N	1	VHn	//인간
お婿さん	신랑#N	1	VHn	//인간
お爺さま	할아버님#N	1	VHn	//인간
お爺ちゃん	할아버지#N	1	VHn	//인간
お爺様	할아버님#N	1	VHn	//인간
お月さま	달님#N	1	VHn	//인간
お月様	달님#N	1	VHn	//인간
お偉いさん	높으신 분#N	1	VHn	//인간
お二人さん	두 사람#N	1	VHn	//인간
お二人様	두 분#N	1	VHn	//인간
お日さま	햇님#N	1	VHn	//인간
お日様	햇님#N	1	VHn	//인간
お子さま	꼬마님#N	1	VHn	//인간
お姉さま	누님#N	1	VHn	//인간
お姉さん	누나#N	1	VHn	//인간
お姉ちゃん	누나#N	1	VHn	//인간
お姉ちゃんっ子	누나쟁이#N	1	VHn	//인간
お姉ちゃん子	누나쟁이#N	1	VHn	//인간
お姉達	누나들#N	1	VHn	//인간
お子様	꼬마님#N	1	VHn	//인간
お姉様	누님#N	1	VHn	//인간
お店屋さん	가게씨#N	1	VHn	//인간
お婆様	할머님#N	1	VHn	//인간
お兄さま	오라버니#N	1	VHn	//인간
お兄さん	오빠#N	1	VHn	//인간
お兄ちゃん	오빠#N	1	VHn	//인간
お兄ちゃんっ子	오빠쟁이#N	1	VHn	//인간
お兄ちゃん子	오빠쟁이#N	1	VHn	//인간
ガイコクジン	외국인#N	1	VHn	//인간
カイロプラクティッカー	카이로프래티커#N	1	VHn	//인간
ががんぼ	꾸정모기#N	1	QAE	//곤충류
ガキンチョ	초딩#N	1	VHn	//인간
カタブツ	고시직한 사람#N	1	VHn	//인간
カメレオン	카멜레온#N	1	QAD	//파충류,양서류
カモノハシ	오리너구리#N	1	QAA	//포유류
かわい子	귀여운 아이#N	1	VHn	//인간
キツネ	여우#N	1	QAA	//포유류
キマイラ	키메라#N	1	QAA	//포유류
キモオタ	키모오타#N	1	VHn	//인간
キモブタ	오크돼지#N	1	VHn	//인간
キャッチャー	캐쳐#N	1	VHn	//인간
きれいどころ	기생#N	1	VHn	//인간
クソアマ	젠장할년#N	1	VHn	//인간
クソガキ	망할 녀석#N	1	VHn	//인간
クソガキッ	망할 자식#N	1	VHn	//인간
クソじじ	망할 영감#N	1	VHn	//인간
クソタレ	똥싸개#N	1	VHn	//인간
くそたれ	똥싸개#N	1	VHn	//인간
クソッタレ	똥싸개#N	1	VHn	//인간
くそったれ	똥싸개#N	1	VHn	//인간
くのいち	쿠노이치#N	1	VHn	//인간
くノ一	쿠노이치#N	1	VHn	//인간
クラスメイト	클래스메이트#N	1	VHn	//인간
グルメ	미식가#N	1	VHn	//인간
ケイサツ	경찰#N	1	VHn	//인간
ケダモノ	짐승#N	1	VAm	//동물
ケチンボ	구두쇠#N	1	VHn	//인간
ケンタラウス	켄타우로스#N	1	VHn	//인간
コアラ	코알라#N	1	QAA	//포유류
コイビト	연인#N	1	VHn	//인간
ゴーレム	골렘#N	1	VHn	//인간
ゴクツブシ	밥벌레#N	1	QAE	//곤충류
ゴスロリ	고스로리#N	1	VHn	//인간
コック長	주방장#N	1	VHn	//인간
コメディアン	코메디언#N	1	VHn	//인간
コヤツ	이 녀석#N	1	VHn	//인간
コレクター	컬렉터#N	1	VHn	//인간
ゴロツキ	불한당#N	1	VHn	//인간
こわがり屋	겁쟁이#N	1	VHn	//인간
こんのやろ	이 자식#N	1	VHn	//인간
こんのやろう	이 자식#N	1	VHn	//인간
コンビ	콤비#N	1	VHn	//인간
ご近所	이웃#N	1	VHn	//인간
ご隠居	노인장#N	1	VHn	//인간
サーヴァント	서번트#N	1	VHn	//인간
サキュバス	서큐버스#N	1	VHn	//인간
ザコ	자코#N	1	VHn	//인간
サッキュバス	서큐버스#N	1	VHn	//인간
サモナー	써모너#N	1	VHn	//인간
シーモンキー	씨몽키#N	1	VHn	//인간
ジェントルメン	젠틀맨#N	1	VHn	//인간
シスコン	시스콘#N	1	VHn	//인간
シスターズ	시스터즈#N	1	VHn	//인간
シモベ	하인#N	1	VHn	//인간
シャーマン	샤먼#N	1	VHn	//인간
シャイシャイボーイ	샤이샤이보이#N	1	VHn	//인간
ジャカール	쟈칼#N	1	QAA	//포유류
スコーピオン	스콜피온#N	1	QAE	//곤충류
スナイパー	스나이퍼#N	1	VHn	//인간
センパイ	선배#N	1	VHn	//인간
センパーイ	선-배#N	1	VHn	//인간
ソウルメイト	소울메이트#N	1	VHn	//인간
ソーサラー	소서러#N	1	VHn	//인간
ダーリン	달링#N	1	VHn	//인간
だいだらぼっち	다이다라봇치#N	1	VHn	//인간
だだっ子	응석꾸러기#N	1	VHn	//인간
ダチ公	친구#N	1	VHn	//인간
ダッチワイフ	더치 와이프#N	1	VHn	//인간
たわけ者	얼간이#N	1	VHn	//인간
ダンゴムシ	쥐며느리#N	1	QAF	//절지동물
チーママ	작은 마담#N	1	VHn	//인간
チビガキ	땅꼬마#N	1	VHn	//인간
チビガキッ	땅꼬마#N	1	VHn	//인간
チビスケ	꼬맹이#N	1	VHn	//인간
チビッ子	꼬맹이#N	1	VHn	//인간
チビっ子	꼬맹이#N	1	VHn	//인간
ちびっ子	꼬맹이#N	1	VHn	//인간
ちび子	꼬맹이#N	1	VHn	//인간
チャラ男	날라리 남자#N	1	VHn	//인간
チャンピオーン	챔피온#N	1	VHn	//인간
チャンプ	챔프#N	1	VHn	//인간
チョウチョ	나비#N	1	QAE	//곤충류
ちょうちょ	나비#N	1	QAE	//곤충류
チンチクリン	땅딸보#N	1	VHn	//인간
ツクツクボウシ	쓰르라미#N	1	QAE	//곤충류
つんでれ	츤데레#N	1	VHn	//인간
ツンデレラ	츤데렐라#N	1	VHn	//인간
ティーチャー	티쳐#N	1	VHn	//인간
デーモン	데몬#N	1	VHn	//인간
テクニシャン	테크니션#N	1	VHn	//인간
デザイナ	디자이너#N	1	VHn	//인간
デザイナー	디자이너#N	1	VHn	//인간
デレスケ	호색남#N	1	VHn	//인간
でれ助	호색남#N	1	VHn	//인간
ドーベルマン	도베르만#N	1	QAA	//포유류
ドクター	닥터#N	1	VHn	//인간
どじっ子	얼빠진 아이#N	1	VHn	//인간
ドスケベ	색마#N	1	VHn	//인간
どちらさま	어느 분#N	1	VHn	//인간
どちらさん	어느 분#N	1	VHn	//인간
ドッペルゲンガー	도플갱어#N	1	VHn	//인간
ドラゴン	드래곤#N	1	QAD	//파충류,양서류
ドワーフ	드워프#N	1	VHn	//인간
ナメクジ	민달팽이#N	1	QAE	//곤충류
ニンゲン	인간#N	1	VHn	//인간
のぞき魔	엿보기 변태#N	1	VHn	//인간
ノロマ	굼벵이#N	1	QAE	//곤충류
バーサーカー	버서커#N	1	VHn	//인간
バイキン	바이킹#N	1	VHn	//인간
バカップル	바보커플#N	1	VHn	//인간
バカモノ	어리석은 것#N	1	VHn	//인간
バツイチ	이혼경험자#N	1	VHn	//인간
バボ	바보#N	1	VHn	//인간
パルチザン	파르티잔#N	1	VHn	//인간
バレリーナ	발레리나#N	1	VHn	//인간
ヒキコモリ	히키코모리#N	1	VHn	//인간
ピッチャー	피쳐#N	1	VHn	//인간
ひとり子	외동아이#N	1	VHn	//인간
ヒネクレ者	핑계쟁이#N	1	VHn	//인간
ビビリ屋	수줍음쟁이#N	1	VHn	//인간
ファザコン	파더콘#N	1	VHn	//인간
フェミニスト	페미니스트#N	1	VHn	//인간
ふつつか者	못난 사람#N	1	VHn	//인간
フリーター	프리터#N	1	VHn	//인간
ブルジョア	부르주아#N	1	VHn	//인간
ブルジョワ	부르주아#N	1	VHn	//인간
ブレイブマン	브레이브맨#N	1	VHn	//인간
フレンズ	프렌즈#N	1	VHn	//인간
ヘタレ	멍청이#N	1	VHn	//인간
ベッピン	미인#N	1	VHn	//인간
へっぽこ	풋내기#N	1	VHn	//인간
ヘナチョコ	풋내기#N	1	VHn	//인간
ボクサー	복서#N	1	VHn	//인간
ボディービルダー	보디빌더#N	1	VHn	//인간
ホルスタイン	젖소#N	1	QAA	//포유류
マザコン	마더콘#N	1	VHn	//인간
マゾ	마조#N	1	VHn	//인간
マッチョ	마초#N	1	VHn	//인간
ムッツリスケベ	내색않는 호색한#N	1	VHn	//인간
メスネコ	암고양이#N	1	QAA	//포유류
メスブタ	암퇘지#N	1	QAA	//포유류
メス犬	암캐#N	1	QAA	//포유류
メス奴隷	암노예#N	1	VHn	//인간
メス豚	암퇘지#N	1	QAA	//포유류
メディック	매딕#N	1	VHn	//인간
メデゥサ	메두사#N	1	VHn	//인간
メデューサ	메두사#N	1	VHn	//인간
モルモット	모르모트#N	1	QAA	//포유류
モンキー	몽키#N	1	QAA	//포유류
モンスタ	몬스터#N	1	VHn	//인간
モンスター	몬스터#N	1	VHn	//인간
ラスボス	라스트 보스#N	1	VHn	//인간
リア充	리얼충#N	1	VHn	//인간
レイディ	레이디#N	1	VHn	//인간
ロクデナシ	밥벌레#N	1	QAE	//곤충류
ろくでなし	밥벌레#N	1	QAE	//곤충류
ロマンティスト	로맨티스트#N	1	VHn	//인간
ロリコン	로리콘#N	1	VHn	//인간
ロンリーガイ	론리 가이#N	1	VHn	//인간
苛められっ子	괴롭혀지는 아이#N	1	VHn	//인간
歌人	시인[歌人]#N	1	VHn	//인간
家人	집안사람[家人]#N	1	VHn	//인간
歌姫	가희[歌姬]#N	1	VHn	//인간
間男	샛서방#N	1	VHn	//인간
巨犬	큰 개#N	1	QAA	//포유류
検非違使	검비위사#N	1	VHn	//인간
見鬼	견귀[見鬼]#N	1	VHn	//인간
庫裏方	조리사#N	1	VHn	//인간
高慢娘	교만한 아가씨#N	1	VHn	//인간
古神	고대신[古神]#N	1	VGn	//신(성인)
公家	공가[公家]#N	1	VHn	//인간
狂人	광인[狂人]#N	1	VHn	//인간
校医	교의#N	1	VHn	//인간
橋姫	하시히메#N	1	VGn	//신(성인)
蚯蚓	지렁이#N	1	QAF	//절지동물
旧人類	구인류#N	1	VHn	//인간
軍曹	군조#N	1	VHn	//인간
鬼嫁	도깨비부인#N	1	VHn	//인간
貴機	귀기[貴機]#N	1	VHn	//인간
鬼神	귀신#N	1	VHn	//인간
鬼姫	귀희[鬼姬]#N	1	VHn	//인간
鬼畜	귀축#N	1	VHn	//인간
根なし草	떠돌이#N	1	VHn	//인간
根無し草	떠돌이#N	1	VHn	//인간
近所さん	이웃씨#N	1	VHn	//인간
機械オンチ	기계치#N	1	VHn	//인간
綺麗所	기생#N	1	VHn	//인간
男魔族	남자마족#N	1	VHn	//인간
男神	남신[男神]#N	1	VGn	//신(성인)
男優	남배우#N	1	VHn	//인간
男子校生	남학생#N	1	VHn	//인간
娘っこ	아가씨#N	1	VHn	//인간	//なんべん言ってもわからん娘っこだ
娘達	아가씨들#N	1	VHn	//인간
娘御	아가씨#N	1	VHn	//인간
女騎士	여기사#N	1	VHn	//인간
女童	여동[女童]#N	1	VHn	//인간
女魔族	여마족#N	1	VHn	//인간
女王様	여왕님#N	1	VHn	//인간
女子供	아녀자#N	1	VHn	//인간
女子校生	여학생#N	1	VHn	//인간
女子生徒	여학생#N	1	VHn	//인간
女将	여주인#N	1	VHn	//인간
女戦士	여전사#N	1	VHn	//인간
女学園生	여학원생#N	1	VHn	//인간
女狐	암여우#N	1	VHn	//인간
年配の方	나이 있으신 분#N	1	VHn	//인간
年増女	노처녀#N	1	VHn	//인간
怒鬼	노귀[怒鬼]#N	1	VHn	//인간
奴隷	노예#N	1	VHn	//인간
奴婢	노비#N	1	VHn	//인간
儂等	우리들#N	1	VHn	//인간
能天使	능천사#N	1	VHn	//인간
茶目	장난꾸러기#N	1	VHn	//인간
茶目っ子	장난꾸러기#N	1	VHn	//인간
旦那さま	서방님#N	1	VHn	//인간
旦那様	서방님#N	1	VHn	//인간
大貴族	대귀족#N	1	VHn	//인간
大馬鹿	왕바보#N	1	VHn	//인간
大馬鹿者	왕바보#N	1	VHn	//인간
大魔神	대마신#N	1	VGn	//신(성인)
大蚊	꾸정모기#N	1	QAE	//곤충류
大変態	대변태#N	1	VHn	//인간
大勢人	많은 사람#N	1	VHn	//인간
対手	적수#N	1	VHn	//인간
大悪魔	대악마#N	1	VHn	//인간
稲荷	곡식의 신#N	1	VGn	//신(성인)
都会っ子	도시 아이#N	1	VHn	//인간
独りっ子	외동아이#N	1	VHn	//인간
独り子	외동아이#N	1	VHn	//인간
頭領	두령#N	1	VHn	//인간
落とし主	분실자#N	1	VHn	//인간
嵐神	폭풍의 신#N	1	VGn	//신(성인)
浪人生	재수생#N	1	VHn	//인간
狼藉者	불한당#N	1	VHn	//인간
両性愛者	양성애자#N	1	VHn	//인간
連れ子	의붓자식#N	1	VHn	//인간
恋人	연인#N	1	VHn	//인간
恋姫	연희[戀姬]#N	1	VHn	//인간
老教師	노교사#N	1	VHn	//인간
老魔術師	노마술사#N	1	VHn	//인간
老王	노왕#N	1	VHn	//인간
老医師	노의사#N	1	VHn	//인간
老執事	노집사#N	1	VHn	//인간
碌でなし	밥벌레#N	1	QAE	//곤충류
碌で無し	밥벌레#N	1	QAE	//곤충류
寮監	기숙사감#N	1	VHn	//인간
寮母	기숙사감#N	1	VHn	//인간
竜騎士	용기사#N	1	VHn	//인간
龍神	용신[龍神]#N	1	VHn	//인간
竜王	용왕#N	1	VGn	//신(성인)
竜族	용족#N	1	QNP	//민족명
魑魅魍魎	온갖 잡귀#N	1	VHn	//인간
馬鹿め	바보놈#N	1	VHn	//인간
馬鹿者	바보녀석#N	1	VHn	//인간
魔物	마물#N	1	VHn	//인간
魔神	마신#N	1	VGn	//신(성인)
魔姫	마희[魔姬]#N	1	VHn	//인간
莫迦	멍청이#N	1	VHn	//인간
万人	만인#N	1	VHn	//인간
末娘	막내딸#N	1	VHn	//인간
亡き陛下	선대 폐하#N	1	VHn	//인간
忘れん坊	잘 잊는 사람#N	1	VHn	//인간
売女	창녀#N	1	VHn	//인간
妹様	여동생님#N	1	VHn	//인간
妹御	여동생분#N	1	VHn	//인간
妹的存在	여동생적 존재#N	1	VHn	//인간
猛者	용맹한 자#N	1	VHn	//인간
眠り姫	잠자는 공주#N	1	VHn	//인간
面倒くさがりや	귀찮음쟁이#N	1	VHn	//인간
面倒くさがり屋	귀찮음쟁이#N	1	VHn	//인간
母さま	어머님#N	1	VHn	//인간
母ちゃん	엄마#N	1	VHn	//인간
牡犬	수캐#N	1	QAA	//포유류
牡豚	수퇘지#N	1	QAA	//포유류
牡獣	수컷짐승#N	1	QAA	//포유류
木精	나무의 정령#N	1	VGn	//신(성인)
夢魔	몽마#N	1	VHn	//인간
猫舌	고양이혀#N	1	VHn	//인간
墓守	묘지기#N	1	VHn	//인간
舞い手	무용수#N	1	VHn	//인간
武骨者	얼뜨기#N	1	VHn	//인간
無骨者	얼뜨기#N	1	VHn	//인간
武者	무사#N	1	VHn	//인간
//美姫	미희[美姬]#N	1	VHn	//인간
薄羽蜻蛉	명주잠자리#N	1	QAE	//곤충류
薄情者	야박한 자#N	1	VHn	//인간
方々	여러분#N	1	VHn	//인간
白面金毛	백면금모#N	1	QAA	//포유류
百人隊長	백인대장#N	1	VHn	//인간
白痴者	얼간이#N	1	VHn	//인간
罰当たりめ	벌 받을 놈#N	1	VHn	//인간
罰当りめ	벌 받을 놈#N	1	VHn	//인간
法王	법왕#N	1	VHn	//인간
普通男	보통남#N	1	VHn	//인간
鳳凰	봉황#N	1	QAB	//조류
富める者	부유한 자#N	1	VHn	//인간
婦警	여경#N	1	VHn	//인간
不届き者	괘씸한 자#N	1	VHn	//인간
父娘	부녀#N	1	VHn	//인간
不埒者	발칙한 놈#N	1	VHn	//인간
浮浪人	부랑자#N	1	VHn	//인간
不良娘	불량한 아가씨#N	1	VHn	//인간
付喪神	츠쿠모가미#N	1	VGn	//신(성인)
不束者	못난 사람#N	1	VHn	//인간
不審者	수상한 자#N	1	VHn	//인간
不真面目君	불성실군#N	1	VHn	//인간
不忠者	불충자#N	1	VHn	//인간
北天神	북천신#N	1	VHn	//인간
比丘尼	비구니#N	1	VHn	//인간
卑劣漢	비열한#N	1	VHn	//인간
飛龍	비룡#N	1	QAD	//파충류,양서류
牝犬	암캐#N	1	QAA	//포유류
牝奴隷	암노예#N	1	VHn	//인간
牝豚	암퇘지#N	1	QAA	//포유류
牝獣	암컷짐승#N	1	VAm	//동물
牝牛	암소#N	1	QAA	//포유류
牝豹	암표범#N	1	QAA	//포유류
牝狐	암여우#N	1	QAA	//포유류
使い魔	사역마#N	1	VHn	//인간
使い手	사용자#N	1	VHn	//인간
捨て犬	유기견#N	1	QAA	//포유류
蛇女	사녀[蛇女]#N	1	VHn	//인간
四神	사신#N	1	VGn	//신(성인)
死神	사신#N	1	VGn	//신(성인)
私様	나님#N	1	VHn	//인간
山神	산신#N	1	VGn	//신(성인)
山人	산인[山人]#N	1	VHn	//인간
三馬鹿	세 바보#N	1	VHn	//인간 : いつの間にかそれが当たり前になって、左月や竜也たちと三バカなんて呼ばれるようになって……
上つ方	높으신 분#N	1	VHn	//인간
色魔	색마#N	1	VHn	//인간
生ける屍	살아있는 시체#N	1	VHn	//인간
甥っ子	조카#N	1	VHn	//인간
生徒会長	학생회장#N	1	VHn	//인간
婿がね	사윗감#N	1	VHn	//인간
蜥蜴	도마뱀#N	1	QAD	//파충류,양서류
先公	선공[先公]#N	1	VHn	//인간
先生様	선생님	1	VHn	//인간
仙人	신선#N	1	VGn	//신(성인)
先祖様	선조님#N	1	VGn	//신(성인)
屑男	쓰레기남#N	1	VHn	//인간
雪女	설녀#N	1	VHn	//인간
聖騎士	성기사#N	1	VHn	//인간
猩猩蠅	초파리#N	1	QAE	//곤충류
性獣	성수[性獸]#N	1	VAm	//동물
星様	별님#N	1	VHn	//인간
性玩具	성도구#N	1	VHn	//인간
歳神	곡식의 신#N	1	VGn	//신(성인)
笑い芸人	희극인#N	1	VHn	//인간
小鬼	작은 귀신#N	1	VHn	//인간
小僧	애송이#N	1	VHn	//인간
小悪魔	소악마#N	1	VHn	//인간
少佐	소좌#N	1	VHn	//인간
送り人	보내는 사람#N	1	VHn	//인간
受ける側	받는 측#N	1	VHn	//인간
受け手	받는편#N	1	VHn	//인간
手ごま	부하#N	1	VHn	//인간
手駒	부하#N	1	VHn	//인간
水竜	수룡#N	1	QAD	//파충류,양서류
睡魔	수마[睡魔]	1	VHn	//인간
水神	수신#N	1	VGn	//신(성인)
獣人	수인[獸人]#N	1	VHn	//인간
水精	물의 정령#N	1	VGn	//신(성인)
熟女	숙녀#N	1	VHn	//인간
宿主	숙주#N	1	VHn	//인간
術者	시술자#N	1	VHn	//인간
柴犬	시바이누#N	1	QAA	//포유류
始末屋	암살자#N	1	VHn	//인간
式神	식신#N	1	VGn	//신(성인)
神の遣い	신의 사자#N	1	VGn	//신(성인)
神様	신님#N	1	VGn	//신(성인)
新卒教員	신입교원#N	1	VHn	//인간
深き方	깊은 분#N	1	VHn	//인간
辻商人	가두상인#N	1	VHn	//인간
十人隊長	십인대장#N	1	VHn	//인간
我ら女	우리 여자#N	1	VHn	//인간
餓畜	굶주린 짐승#N	1	VAm	//동물
悪ガキ	못된 꼬마#N	1	VHn	//인간
悪霊#N	악령#N	1	VHn	//인간
悪獣	악한 짐승#N	1	VAm	//동물
悪戯っ子	장난꾸러기#N	1	VHn	//인간
愛息	애식[愛息]#N	1	VHn	//인간
愛息子	애식[愛息]#N	1	VHn	//인간
厄介者	애물단지#N	1	VHn	//인간
爺ちゃん	할아버지#N	1	VHn	//인간
野盗	도둑#N	1	VHn	//인간
爺様	할아버님	1	VHn	//인간
若嫁	젊은 신부#N	1	VHn	//인간
若旦那	큰 도련님#N	1	VHn	//인간
若旦那様	큰도련님#N	1	VHn	//인간
若奥	젊은 부인#N	1	VHn	//인간
若奥様	젊은 사모님#N	1	VHn	//인간
嬢ちゃん	아가씨#N	1	VHn	//인간
御客様	손님#N	1	VHn	//인간
御客人	손님#N	1	VHn	//인간
御頭	두령#N	1	VHn	//인간
御仁	양반#N	1	VHn	//인간
御子	천황의 자녀#N	1	VHn	//인간
言いだしっぺ	말 꺼낸 사람#N	1	VHn	//인간
言い出しっぺ	먼저 말을 시작한 사람#N	1	VHn	//인간
言い出しっ屁	먼저 말을 시작한 사람#N	1	VHn	//인간
余所者	낯선 사람#N	1	VHn	//인간
如何様師	사기꾼#N	1	VHn	//인간
軟弱者	나약자#N	1	VHn	//인간
影女	영녀[影女]#N	1	VHn	//인간
英雄様	영웅님#N	1	VHn	//인간
裔子	후손#N	1	VHn	//인간
汚っさん	아저씨#N	1	VHn	//인간
王太子	왕태자#N	1	VHn	//인간
王太子妃	왕태자비#N	1	VHn	//인간
妖し	요괴#N	1	VHn	//인간
妖魔	요마#N	1	VHn	//인간
饒舌家	수다쟁이#N	1	VHn	//인간
妖狐	요호[妖狐]#N	1	QAA	//포유류
愚か者	어리석은 자#N	1	VHn	//인간
愚か者め	어리석은 놈#N	1	VHn	//인간
右大臣	우대신#N	1	VHn	//인간
愚物	어리석은 것#N	1	VHn	//인간
愚民	우민#N	1	VHn	//인간
愚者	어리석은 자#N	1	VHn	//인간
愚帝	어리석은 왕#N	1	VHn	//인간
優婆塞	출가하지 않은 승려#N	1	VHn	//인간
羽虫	날벌레#N	1	QAE	//곤충류
雄犬	수캐#N	1	QAA	//포유류
雄豚	수퇘지#N	1	QAA	//포유류
元気娘	기운찬 아가씨#N	1	VHn	//인간
元恋人	옛 연인#N	1	VHn	//인간
月人	월인[月人]#N	1	VHn	//인간
慰み者	노리겟감#N	1	VHn	//인간
委員長	위원장#N	1	VHn	//인간
幼女	유녀[幼女]#N	1	VHn	//인간
幼馴染み	소꿉친구#N	1	VHn	//인간
有翼生物	유익생물#N	1	VAm	//동물
幼帝	유제[幼帝]#N	1	VHn	//인간
肉嫁	고기 신부#N	1	VHn	//인간
肉奴隷	육노예#N	1	VHn	//인간
隠者	은둔자#N	1	VHn	//인간
淫魔	음마#N	1	VHn	//인간
義理の父	의부#N	1	VHn	//인간
義妹	의매[義妹]#N	1	VHn	//인간
義母	의모#N	1	VHn	//인간
義父	의부#N	1	VHn	//인간
義姉	의누이#N	1	VHn	//인간
義姉弟	의남매#N	1	VHn	//인간
耳年増	성숙한 처녀[耳年增]#N	1	VHn	//인간
異母弟	이복동생#N	1	VHn	//인간
人間族	인간족#N	1	QNP	//민족명
人狼	인랑[人狼]#N	1	VHn	//인간
仁王	인왕[仁王]#N	1	VHn	//인간
忍王	인왕[忍王]#N	1	VHn	//인간
人族	인족[人族]#N	1	QNP	//민족명
人型	인형#N	1	VHn	//인간
一粒種	외동#N	1	VHn	//인간
一児	한 아이#N	1	VHn	//인간
一人っ子	외동아이#N	1	VHn	//인간
一人子	외동아이#N	1	VHn	//인간
一学生	한 학생#N	1	VHn	//인간
姉さま	누님#N	1	VHn	//인간
姉さん	누나#N	1	VHn	//인간
姉ちゃん	누나#N	1	VHn	//인간
仔犬	강아지#N	1	QAA	//포유류
雌犬	암캐#N	1	QAA	//포유류
子供	아이#N	1	VHn	//인간
子共	아이#N	1	VHn	//인간
仔供	자공[仔供]#N	1	VHn	//인간
雌奴隷	암노예#N	1	VHn	//인간
雌豚	암퇘지#N	1	QAA	//포유류
雌鹿	암사슴#N	1	QAA	//포유류
仔描	새끼고양이#N	1	QAA	//포유류
仔猫	새끼고양이#N	1	QAA	//포유류
自分たち	자신들#N	1	VHn	//인간
姉様	누님#N	1	VHn	//인간
雌鳥	암탉#N	1	QAB	//조류
茨姫	잠자는 공주#N	1	VHn	//인간
雌雉	암꿩#N	1	QAB	//조류
子兎	작은 토끼#N	1	QAA	//포유류
雌狐	암여우#N	1	QAA	//포유류
雑魚	송사리#N	1	QAC	//어류
姐さん	누님#N	1	VHn	//인간
狙撃主	저격수#N	1	VHn	//인간
赤騎士	붉은 기사#N	1	VHn	//인간
戦狂	전쟁광#N	1	VHn	//인간
転校生	전학생#N	1	VHn	//인간
戦鬼	전귀[戰鬼]#N	1	VHn	//인간
田舎者	촌사람#N	1	VHn	//인간
戦乙女	전처녀#N	1	VHn	//인간
戦姫	전희[戰姬]#N	1	VHn	//인간
店員	점원#N	1	VHn	//인간
正騎士	정식기사#N	1	VHn	//인간
町娘	마을아가씨#N	1	VHn	//인간
整体師	정체사#N	1	VHn	//인간
精子狂	정액광#N	1	VHn	//인간
正解者	정답자#N	1	VHn	//인간
弟妹	동생#N	1	VHn	//인간
操り人形	꼭두각시#N	1	VHn	//인간
鳥頭	새대가리#N	1	QAB	//조류
助兵衛	호색가#N	1	VHn	//인간
祖父	조부#N	1	VHn	//인간
従者	수행원#N	1	VHn	//인간
従兄	사촌형#N	1	VHn	//인간
従兄妹	사촌남매#N	1	VHn	//인간
座敷童子	좌부동자#N	1	VGn	//신(성인)
主達	주인들#N	1	VHn	//인간
仲居	하녀#N	1	VHn	//인간
中年男	중년남#N	1	VHn	//인간
重歩兵	중보병#N	1	VHn	//인간
重戦士	중전사#N	1	VHn	//인간
只者	보통사람#N	1	VHn	//인간
地精	땅의 정령#N	1	VGn	//신(성인)
織姫	직녀#N	1	VHn	//인간
真面目君	성실군#N	1	VHn	//인간
借金取り	빚쟁이#N	1	VHn	//인간
蒼龍	청룡#N	1	QAD	//파충류,양서류
采女	궁녀#N	1	VHn	//인간
天邪鬼	심술쟁이#N	1	VHn	//인간
千人隊長	천인대장#N	1	VHn	//인간
川赤子	카와아가코#N	1	VGn	//신(성인)
妾腹	첩복[妾腹]#N	1	VHn	//인간
青竜	청룡#N	1	QAD	//파충류,양서류
招き猫	복고양이#N	1	QAA	//포유류
村娘	마을 아가씨#N	1	VHn	//인간
村人女	마을여자#N	1	VHn	//인간
総司令官	총사령관#N	1	VHn	//인간
枢機卿	추기경#N	1	VHn	//인간
雛鳥	아기새#N	1	QAB	//조류
出目金	눈툭금붕어#N	1	QAC	//어류
側女	시녀#N	1	VHn	//인간
恥ずかしがり屋	부끄럼쟁이#N	1	VHn	//인간
痴女	치녀#N	1	VHn	//인간
治天の君	태상천황#N	1	VHn	//인간
親父殿	아버님#N	1	VHn	//인간
七人ミサキ	7인미사키#N	1	VGn	//신(성인)
他部族	타부족#N	1	VGt	//집합(군집)
太母	태모[太母]#N	1	VHn	//인간
太夫	타유[太夫]#N	1	VHn	//인간
駄駄っ子	응석쟁이#N	1	VHn	//인간
八咫鴉	야타가라스#N	1	VGn	//신(성인)
貝獣	패수[貝獸]#N	1	QAC	//어류
唄姫	패희[唄姬]#N	1	VHn	//인간
彼氏	남자친구#N	1	VHn	//인간
荷物持ち	짐꾼#N	1	VHn	//인간
何屋さん	뭐하는 사람#N	1	VHn	//인간
下種	천한 신분#N	1	VHn	//인간
下衆	천한 신분#N	1	VHn	//인간
学院生	학원생#N	1	VHn	//인간
行かず後家	노처녀#N	1	VHn	//인간
香天女	향천녀#N	1	VGn	//신(성인)
兄さま	오라버니#N	1	VHn	//인간
兄さん	오빠#N	1	VHn	//인간
兄ちゃん	오빠#N	1	VHn	//인간
兄貴	형님#N	1	VHn	//인간
兄様	오라버니#N	1	VHn	//인간
兄者	형님#N	1	VHn	//인간
兄者殿	형님#N	1	VHn	//인간
兄弟子	동문선배#N	1	VHn	//인간
狐狸	호리#N	1	QAA	//포유류
好青年	호청년[好靑年]#N	1	VHn	//인간
好々爺	마음좋은 할아범#N	1	VHn	//인간
好好爺	마음좋은 할아범#N	1	VHn	//인간
紅鱒	홍송어#N	1	QAC	//어류
化ケ物	괴물#N	1	VHn	//인간
火龍	화룡#N	1	QAD	//파충류,양서류
火蜥蜴	불도마뱀#N	1	QAD	//파충류,양서류
火星人	화성인#N	1	VHn	//인간
和人	일본인#N	1	VHn	//인간
丸裸	벌거숭이#N	1	VHn	//인간
慌ん坊	덜렁이#N	1	VHn	//인간
荒神	아라가미[荒神]	1	VGn	//신(성인)
皇太弟	황태제#N	1	VHn	//인간
虫ケラ	버러지#N	1	QAE	//곤충류
戯け者	얼간이#N	1	VHn	//인간
雨女	우녀[雨女]#N	1	VHn	//인간
元カノ	전여친#N	1	VHn	//인간
新米教師	신입교사#N	1	VHn	//인간
内弁慶	집에서만 큰소리#N	1	VHn	//인간
//臆病	겁쟁이#N	0	VHn	//인간
介護者	간병인#N	1	VHn	//인간
ヒメアカタテハ	작은멋쟁이나비#N	1	QAE	//곤충류
ヤマガミサマ	산신님#N	1	VGn	//신(성인)
開祖	개조[開祖]#N	1	VHn	//인간
ヤマネコ	산고양이#N	1	QAA	//포유류
学園長	학원장#N	1	VHn	//인간
浪人	낭인#N	1	VHn	//인간
妹君	여동생군#N	1	VHn	//인간
姉君	누나군#N	1	VHn	//인간 : 姉君の危機を助けてはくれないか？
目付	감찰무사#N	1	VHn	//인간
亡き殿	돌아가신 분[殿]#N	1	VHn	//인간
妹達	여동생들#N	1	VHn	//인간
末の娘	막내딸#N	1	VHn	//인간
そなた	그대#N	1	VHn	//인간
トモダチ	친구#N	1	VHn	//인간
ネボスケ	잠꾸러기#N	1	VHn	//인간
マヌケ	얼간이#N	1	VHn	//인간
ゆかいはん	유괴범#N	1	VHn	//인간
俊秀	준재[俊秀]#N	1	VHn	//인간
あいっつ	저 녀석#N	1	VHn	//인간
あいじん	애인#N	1	VHn	//인간
早食い王	빨리먹기왕#N	1	VHn	//인간
拗ねキャラ	삐짐 캐릭터#N	1	VHn	//인간
情報屋	정보상#N	1	VHn	//인간 : 情報屋の手が、苦しげに俺の襟を掴んだ。
いいんちょ	위원장#N	1	VHn	//인간 :
//いなご	메뚜기#N	1	VHn	//인간 :
イタズラっ子	장난꾸러기#N	1	VHn	//인간 :
イソガニ	바위게#N	1	VAm	//동물
イワガニ	바위게#N	1	VAm	//동물
ぼうや	꼬마#N	1	VHn	//인간 :
ロマンチスト	로맨티스트#N	1	VHn	//인간 :
従姉弟	사촌동생#N	1	VHn	//인간 :
女兵	여자 병사#N	1	VHn	//인간 :
トビウオ	날치#N	1	VAm	//동물
仔豚	새끼돼지#N	1	VAm	//동물
仔羊	새끼양#N	1	VAm	//동물
金食い虫	돈 먹는 벌레#N	1	VHn	//인간 :
コンシェルジュ	콩셰르주#N	1	VHn	//인간 :
座敷童	좌부동#N	1	VHn	//인간 :
影武者	카케무사#N	1	VHn	//인간 :
借り腹	씨받이#N	1	VHn	//인간 :
成り金	벼락부자#N	1	VHn	//인간 :
モンゴリアン	몽골리안#N	1	QNP	//민족명
穴熊	오소리#N	1	VAm	//동물
賞金首	현상범#N	1	VHn	//인간 :
神隠し	카미카쿠시[神隱し]	1
おじさま	아저씨#N	1	VHn	//인간 :
実姉	친누나#N	1	VHn	//인간 :
虎魚	쑤기미[虎魚]#N	1	VAm	//동물
誰彼	이 사람 저 사람#N	1	VHn	//인간 : なにしろ誰彼かまわず声を掛けてるのはみんな知ってますし
一人ぼっち	외톨이#N	1	VHn	//인간 :
アンモナイト	암모나이트#N	1	VAm	//동물
ピラニア	피라니아#N	1	VAm	//동물
姫君	아가씨#N	1	VHn	//인간 :
アフガンハウンド	아프간 하운드#N	1	VAm	//동물
柳葉魚	열빙어#N	1	VAm	//동물
のら猫	길고양이#N	1	VAm	//동물
ひよっこ	애송이#N	1	VHn	//인간 :
ヒヨッコ	애송이#N	1	VHn	//인간 :
大食家	대식가#N	1	VHn	//인간 :
//お嬢さん	아가씨#N	1	VHn	//인간 :
ど変態	변태#N	1	VHn	//인간 : **そのほど変態。このど変態。
イタズラ子	장난꾸러기#N	1	VHn	//인간 :
おてつだいさん	가정부#N	1	VHn	//인간 :
ごしゅじん	주인#N	1	VHn	//인간 : ごしゅじんさま
おばぁさん	아줌마#N	1	VHn	//인간 :
おばーさん	아줌마#N	1	VHn	//인간 :
だんな様	서방님#N	1	VHn	//인간 :
おこっちゃま	꼬마님#N	1	VHn	//인간 :
おこちゃま	꼬마님#N	1	VHn	//인간 :
お人よし	호인#N	1	VHn	//인간 :
お好よし	호인#N	1	VHn	//인간 :
寝ぼすけ	잠꾸러기#N	1	VHn	//인간 :
能転気	덜렁이#N	1	VHn	//인간 :
脳天気	덜렁이#N	1	VHn	//인간 :
後添い	후처#N	1	VHn	//인간 : 後添えの連れ子でも他人だ。後添えの連れ子ではだめか。
後添え	후처#N	1	VHn	//인간 :
忘れんぼう	잘 잊는 사람#N	1	VHn	//인간 : 忘れんぼうさん
仲間達	동료들#N	1	VHn	//인간 : 仲間達に直接お願いする。
おいらたち	우리들#N	1	VHn	//인간 :
お婆ちゃん	할머니#N	1	VHn	//인간 :
たったひとり	단 한사람#N	1	VHn	//인간 : たったひとりの戦士
初カノ	첫그녀#N	1	VHn	//인간 :
イタズラッ子	장난꾸러기#N	1	VHn	//인간 :
地上げ屋	땅투기꾼#N	1	VHn	//인간 :
トーヘンボク	벽창호#N	1	VHn	//인간 :
負うた子	업은 아이#N	1	VHn	//인간 : 負うた子に教わる
夢想家	몽상가#N	1	VHn	//인간 :
ボンクラ	멍청이#N	1	VHn	//인간 :
ぼんくら	멍청이#N	1	VHn	//인간 : このボンクラと何があったんだ！？
エライヒト	대단한 사람#N	1	VHn	//인간 :
おりこうさん	똘똘이씨#N	1	VHn	//인간 : 課金アイテムで出たら一番売れそうなのはおりこうさん羅針盤
腹黒女	뱃속 검은 여자#N	1	VHn	//인간 :
腹黒男	뱃속 검은 남자#N	1	VHn	//인간 :
女たらし	난봉꾼#N	1	VHn	//인간 : ただの女たらしより聞き捨てならない。
頑張り屋	노력파#N	1	VHn	//인간 :
虎児	새끼 호랑이#N	1	VAm	//동물
空を飛ぶ鳥	하늘을 나는 새#N	1	VAm	//동물
荒鷲	용맹한 독수리#N	1	VAm	//동물
愛娘	사랑스런 딸#N	1	VHn	//인간 :
がきんちょ	꼬맹이#N	1	VHn	//인간 :
贋者	가짜#N	1	VHn	//인간 :
腑抜け	겁쟁이#N	1	VHn	//인간 :
ドザエモン	익사자#N	1	VHn	//인간 :
ゴールデンレトリバー	골든 리트리버#N	1	VAm	//동물
彼氏彼女	그와 그녀#N	1	VHn	//인간 :
コスプレイヤー	코스플레이어#N	1	VHn	//인간 :
ぽっと出	풋내기#N	1	VHn	//인간 :
来訪者	내방자#N	1	VHn	//인간 :
料理長	요리장#N	1	VHn	//인간 :
ばけもの	괴물#N	1	VHn	//인간 :
名たんてい	명탐정#N	1	VHn	//인간 :
ひとさらい	유괴범#N	1	VHn	//인간 :
女主人	여주인#N	1	VHn	//인간 : 女主人と召使いごっこしたり。
たびびと	여행자#N	1	VHn	//인간 :
下級生	하급생#N	1	VHn	//인간 : 下級生の子
馬鹿もん	바보#N	1	VHn	//인간 :
馬鹿モン	바보#N	1	VHn	//인간 :
でくの坊	멍청이#N	1	VHn	//인간 :
只人	보통 사람#N	1	VHn	//인간 :
面食い	얼굴 밝하는 사람#N	1	VHn	//인간 :
面喰い	얼굴 밝하는 사람#N	1	VHn	//인간 :
犬っころ	강아지#N	1	VAm	//동물
死霊	사령[死靈]#N	1	VHn	//인간 :
九尾の狐	구미호#N	1	VAm	//동물
九尾のきつね	구미호#N	1	VAm	//동물
九尾のキツネ	구미호#N	1	VAm	//동물
小夜啼鳥	밤꾀꼬리#N	1	VAm	//동물
引く手	권유하는 사람#N	1	VHn	//인간 :
オオクワガタ	왕사슴벌레#N	1	VAm	//동물
カラスアゲハ	제비나비#N	1	VAm	//동물
夢見師	몽견사#N	1	VHn	//인간 :
小坊主	꼬마#N	1	VHn	//인간 :
さらし者	죄인#N	1	VHn	//인간 :
子泣き爺	코나키지지#N	1	VHn	//인간 : 요괴이름
野良猫	길고양이#N	1	VAm	//동물
のらねこ	길고양이#N	1	VAm	//동물
手足れ	달인#N	1	VHn	//인간 :
手練れ	달인#N	1	VHn	//인간 :
ハツカネズミ	생쥐#N	1	VAm	//동물
殿上人	당상관#N	1	VHn	//인간 :
大美女	대미녀#N	1	VHn	//인간 : 世界三大美女
三大美女	3대 미녀#N	1	VHn	//인간 :
パトラッシュ	파트라슈#N	1	VAm	//동물
大政治家	대정치가#N	1	VHn	//인간 :
イヌイット	이누이트	1	QNP	//민족명
センザンコウ	천산갑#N	1	VAm	//동물
赤の他人	생판 남#N	1	VHn	//인간 :
阿弥陀如来	아미타여래#N	1	VGn	//신(성인)
窮鼠	궁지에 몰린 쥐#N	1	VAm	//동물
おさな友達	소꿉친구#N	1	VHn	//인간 :
本諸子	혼모로코#N	1	VAm	//동물 : 일본 고유 어종이라 함.
ばばあ	할머니#N	1	VHn	//인간 :
曰くつきの女子	과거가 있는 여자#N	1	VHn	//인간 :
おいなりさん	곡식의 신#N	1	VGn	//신(성인)
犬ッコロ	강아지#N	1	VAm	//동물
狩る者	사냥하는 자#N	1	VHn	//인간 :
狩られる者	사냥 당하는 자#N	1	VHn	//인간 :
ポッと出	풋내기#N	1	VHn	//인간 :
半端者	어중간한 놈#N	1	VHn	//인간 :
招かざる客	초대하지 않은 손님#N	1	VHn	//인간 :
絵描き	그림쟁이#N	1	VHn	//인간 :
ファーザー	파더#N	1	VHn	//인간 :
麒麟児	기린아#N	1	VHn	//인간 :
わんぱく	장난꾸러기#N	1	VHn	//인간 :
トナカイ	순록#N	1	VAm	//동물
仲好し小好し	단짝#N	1	VHn	//인간 :
ヘッポコ	풋내기#N	1	VHn	//인간 :
マルチーズ	말티즈#N	1	VAm	//동물
表六玉	얼간이#N	1	VHn	//인간 :
オオアリクイ	큰개미핥기#N	1	VAm	//동물
産女	임산부#N	1	VHn	//인간 :
ウエイトレス	웨이트리스#N	1	VHn	//인간 :
ワーカーホリック	워커홀릭#N	1	VHn	//인간 :
ヨルムンガンド	요르문간드#N	1	VAm	//동물북유럽 신화의 괴물
ソムリエ	소믈리에#N	1	VHn	//인간 :
足長おじさん	키다리 아저씨#N	1	VHn	//인간 :
臆病神	겁쟁이 귀신#N	1	VHn	//인간 :
臆病者	겁쟁이#N	1	VHn	//인간 :
狂言回し	배후 인물#N	1	VHn	//인간 :
ショコラティエ	쇼콜라티에#N	1	VHn	//인간 : 초콜렛 만드는 사람
亡き天才	죽은 천재#N	1	VHn	//인간 :
亡き国王	작고한 국왕#N	1	VHn	//인간 :
亡き両親	돌아가신 양친#N	1	VHn	//인간 :
ジュウシマツ	십자매#N	1	VAm	//동물
天の御遣い	하늘의 사자#N	1	VHn	//인간 :
さみしがりや	외로움쟁이#N	1	VHn	//인간 :
せっかちさん	성급한씨#N	1	VHn	//인간 :
くるみ割人形	호두까기 인형#N	1	VHn	//인간 :
かぎっ子	맞벌이집 아이#N	1	VHn	//인간 :
鍵っ子	맞벌이집 아이#N	1	VHn	//인간 :
へたれ弟	멍청이 남동생#N	1	VHn	//인간 :
鬼武者	귀무자#N	1	VHn	//인간 :
ひとり娘	외동딸#N	1	VHn	//인간 :
黙り屋	과묵한 사람#N	1	VHn	//인간 :
障がい者	장애자#N	1	VHn	//인간 :
おちゃらけたキャラ	장난스러운 캐릭터#N	1	VHn	//인간 :
チョウザメ	철갑상어#N	1	QAC	//어류
笛吹き男	피리 부는 사나이#N	1	VHn	//인간 :
執刀医	집도의#N	1	VHn	//인간 :
すけこまし	여자 낚시꾼#N	1	VHn	//인간 :
スケコマシ	여자 낚시꾼#N	1	VHn	//인간 :
ばあや	노파#N	1	VHn	//인간 :
あぶらむし	진딧물#N	1	VAm	//동물
アブラムシ	진딧물#N	1	VAm	//동물
打ち手	치는 자#N	1	VAm	//동물
嬢さん	아가씨#N	1	VHn	//인간 :
フンコロガシ	말똥구리#N	1	VAm	//동물
海豚	돌고래#N	1	VAm	//동물
蜈蚣	지네#N	1	VAm	//동물
筋者	스지몽#N	1	VHn	//인간 :
屑虫	쓰레기 벌레#N	1	VAm	//동물
手妻使い	요술쟁이#N	1	VHn	//인간 :
旗本	쇼군 직속#N	1	VHn	//인간 :
真打	신우치[眞打]#N	1	VHn	//인간 :


//'명사
アーティスティック	아티스틱	1
アーマー	아머	1	VCp	//의복
アールグレイ	얼그레이	1	VFd	//음식(음료) :
アイサツ	인사	1
アヴァランチ	아발란체	1
あえぎ	헐떡거림	1	UHr	//음성(음향) :
アエギ声	허덕이는 소리	1	UHr	//음성(음향) :
あかね色	붉은색	1	UCr	//색상
あがり症	울렁증	1	UTi	//질병 :
あかんべ	메롱	1
あっかんべ	메롱	1
アキバ	아키바	1
アクビ	하품	1
アクメ	절정	1
アサルトライフル	어셜트라이플	1	VTw	//무기 :
アダルティ	어덜티	1	UYh	//외적 형용
アチコチ	여기저기	1	VPl	//장소 :
あったま	머리	1	VBp	//신체부위 :
アップルティー	애플티	1	VFd	//음식(음료) :
あつらえむき	안성맞춤	1
アトラクション	어트렉션	1
アトランチス	아틀란티스	1	QCTVPl	//장소, 지명 :
アトランティス	아틀란티스	1	QCTVPl	//장소, 지명 :
アナウンス	어나운스	1
アナル	애널	1	VBp	//신체부위 :
アバンチュール	아방튜르	1
アビリティ	어빌리티	1
アフタケアー	애프터캐어	1
あべこべ	뒤바뀜	1
アポカリプス	아포칼립스	1
アホ面	바보 같은 얼굴	1	VBp	//신체부위 :
アミュレット	아뮬렛	1	VAc	//장신구
アメジスト	자수정	1	VJw	//보석
アメニティ	편의시설	1
アリジゴク	개미지옥	1
あるばいと	아르바이트	1
アレコレ	이것저것	1
あれっきり	저것 뿐	1
アロマ	아로마	1
あんころもち	팥소떡	1	VFd	//음식(음료) :
アンバタ	단팥버터빵	1	VFd	//음식(음료) :
あんばた	단팥버터빵	1	VFd	//음식(음료) :
アンバランス	언밸런스	1
あんパン	팥빵	1	VFd	//음식(음료) :
あんぱん	팥빵	1	VFd	//음식(음료) :
あんみつ	앙미츠	1	VFd	//음식(음료) :
イースター	이스터	1
イイデキ	잘 만듦	1
イイトコロ	좋은 곳	1	VPl	//장소 :
イエロ	옐로	1
イカサマ	사기	1
イカレた話	얼빠진 이야기	1
イキサツ	경위	1
イキッぱなし	가고 있는 채	1
イキっぱなし	가고 있는 채	1
イキッぷり	가는 모습	1
苛められっぱなし	괴롭혀지고 있는 채	1
柔手	부드러운 손	1	VBp	//신체부위 :
脹脛	장딴지	1	VBp	//신체부위 :
イキ方	가는 방법	1
イキ声	가는 소리	1	UHr	//음성(음향) :
イキ顔	가는 얼굴	1	VBp	//신체부위 :
イグザクトリ	이그잭틀리	1
イケニエ	제물	1
イケ面	멋진 얼굴	1	VBp	//신체부위 :
いけ炭	잿불	1
いけ火	숯불	1
イジメ甲斐	괴롭히는 보람	1	UFl	//감정
いじめ甲斐	괴롭히는 보람	1	UFl	//감정
イタメシ	이탈리아밥	1	VFd	//음식(음료) :
イチイチ	하나하나	1
イチゴ味	딸기맛	1	UYa	//맛(미각) :
いぢめ	괴롭힘	1
いっきいちゆう	일희일비	1
いっしんいったい	일진일퇴	1
いっせきにちょ	일석이조	1
いっちょういっせき	일조일석	1
いっちょういったん	일장일단	1
イッパツ	한 발	1
イナズマ	번개	1
イニシアチブ	이니셔티브	1
イビキ	코고는 소리	1	UHr	//음성(음향) :
イミニティー	이뮤너티	1
イメクラ	이미지클럽	1	VPl	//장소 :
イメチェン	이미지 체인지	1
イメトレ	이미지 트레이닝	1
イモータル	임모탈	1
イヤガラセ	짓궂은 장난	1
イヤフォン	이어폰	1	VPe	//도구
イヤホン	이어폰	1	VPe	//도구
イングラム	잉그램	1
インスパイア	인스파이어	1
インパルス	임펄스	1
インボー	음모	1
う・そ	거·짓·말	1
ヴァイタルエクステンション	바이탈 익스텐션	1
ヴァギナ	바기나	1	VBp	//신체부위 :
ヴィジュアルノヴェル	비주얼노벨	1	VBk	//책
ヴィデオ	비디오	1
ウェットティッシュ	물티슈	1
ウォーターブレイド	워터블레이드	1
うずみ火	숯불	1
うすら笑い	엷은 웃음	1
うす桃色	연분홍	1	UCr	//색상
うす笑い	엷은 웃음	1
うどんそば	우동소바	1	VFd	//음식(음료) :
ウメボシ	매실장아찌	1	VFd	//음식(음료) :
うるとら	울트라	1
うわの空	건성	1
ウンコ	똥	1	VLu	//분비물
ウンチ	응가	1	VLu	//분비물
えいえん	영원	1
エイチツーオー	H2O	1	VLq	//액체
エキゾチック	이그자틱	1	UYh	//외적 형용
エクスカリバー	엑스칼리버	1	VTw	//무기 :
エクスプロード	익스플로드	1
エクトプラズム	엑토프라즘	1
えづけ	길들임	1
エブリバデェ	에브리바디	1
エリクサー	에릭서	1
エルボードロップ	엘보드롭	1	UTt	//기술
エレメンタル	엘레멘탈	1
えろいこと	에로한 것	1
えろいもの	에로한 것	1
エロゲー	에로게임	1
エンカウント	인카운터	1
エンコー	원조교제	1
エンジョイ	엔조이	1
エントランス	엔트렌스	1
オ○ンコ	보지	1	VBp	//신체부위 :
お○んこ	보지	1	VBp	//신체부위 :
オ○ンチン	자지	1	VBp	//신체부위 :
お○んちん	자지	1	VBp	//신체부위 :
オ○ンポ	자지	1	VBp	//신체부위 :
オウム返し	앵무새 흉내	1
オーラ	오라	1
おかえし	답례	1
オカズ	반찬	1	VFd	//음식(음료) :
オカルティック	오컬틱	1
オカルト	오컬트	1
おごりどころ	한턱 쏠 곳	1	VPl	//장소
オシオキ	벌	1	UPp	//상&벌
おしおき	벌	1	UPp	//상&벌
おしごと	일	1
オシッコ	오줌	1	VLu	//분비물
オシマイ	끝	1
おしゃぶり	빨기	1	//また顔を伏せておしゃぶりを再開させた。
おじゃん	허사	1
オシリ	엉덩이	1	VBp	//신체부위 :
オスマラ	수컷음경	1	VBp	//신체부위 :
おそうじ	청소	1
おためごかし	남을 위해주는 체	1
おたんじょうび	생일	1
おたんじょう日	생일	1
おたんじょーび	생일	1
オチ○チン	자지	1	VBp	//신체부위 :
おチ○チン	자지	1	VBp	//신체부위 :
おち○ちん	자지	1	VBp	//신체부위 :
オチ○ポ	자지	1	VBp	//신체부위 :
おち○ぽ	자지	1	VBp	//신체부위 :
オチ〇チン	자지	1	VBp	//신체부위 :
おちょこ	술잔	1
おチン○ン	자지	1	VBp	//신체부위 :
オチンポ	자지	1	VBp	//신체부위 :
オチンポッ	자지	1	VBp	//신체부위 :
オツマミ	술안주	1	VFd	//음식(음료) :
オツユ	국물	1	VFd	//음식(음료) :
おツユ	국물	1	VFd	//음식(음료) :
オナニー	자위	1
オナホ	오나홀	1	VPe	//도구
オナホール	오나홀	1	VPe	//도구
オネダリ	졸라댐	1
おねだり	졸라댐	1
オハナシ	이야기	1
オブリージュ	오블리주	1
オブリッジ	오블리지	1
おへそ	배꼽	1	VBp	//신체부위 :
おべんきょう	공부	1
おべんと	도시락	1	VFd	//음식(음료) :
オマ○コ	보지	1	VBp	//신체부위 :
おま○こ	보지	1	VBp	//신체부위 :
オマコ	보지	1	VBp	//신체부위 :
オマンコッ	보지	1	VBp	//신체부위 :
オムそばパン	오므라이스빵	1	VFd	//음식(음료) :
オムツ	기저귀	1
オムライス	오무라이스	1	VFd	//음식(음료) :
おめざめ	눈을 뜸	1
おもてなし	대접	1
オモラシ	실금	1
おやすみのキス	잘자요 키스	1
おやすみの日	쉬는 날	1
オヤツ	간식	1	VFd	//음식(음료) :
オヤツッ	간식	1	VFd	//음식(음료) :
オリエンタル	오리엔탈	1
おりんご	사과	1	QAM	//과일명
オリンポス	올림푸스	1	QCTVPl	//장소,지명 :
オルタネイティヴ	얼터너티브	1
オンスケジュール	온스케줄	1
おんなごころ	여자 마음	1
お家柄	집 안	1	VPl	//장소 :
お見送り	전송	1
お届け物	전달물	1
お茶碗	밥공기	1	VCk	//주방기기
お茶漬け	챠즈케	1	VFd	//음식(음료) :
お茶請け	과자	1	VFd	//음식(음료) :
お漏らし	실금	1
お隣さんづきあい	이웃교제	1
お馬さんごっこ	말타기놀이	1
お目汚し	안구테러	1
お墓の中	무덤속	1	VPl	//장소 :
お味噌	된장	1	VFd	//음식(음료) :
お味噌汁	된장국	1	VFd	//음식(음료) :
お返事	회답	1
お腹の奥	뱃속	1	VPl	//장소 :
お腹立ち	성냄	1	UFl	//감정
お腹回り	배 둘레	1
お仕置き	벌	1	UPp	//상&벌
お小水	소변	1	VLu	//분비물
お愛想	겉치례	1
お前ん家	너희집	1	VPl	//장소 :
お情け	자비	1
お釣り銭	거스름돈	1
お昼時	점심 때	1	UMe	//시간 :
お昼寝	낮잠	1
お姫様だっこ	공주님 안기	1
お姫様抱っこ	공주님 안기	1
お休みの挨拶	잘 자요의 인사	1
お休みの日	쉬는 날	1
ガーゼ	거즈	1
ガーター	가터	1
ガード	가드	1
カーリングエンジェルス	컬링엔젤스	1
カイロプラクティック	카이로프래틱	1
カウパー	쿠퍼	1
カカト	뒤꿈치	1	VBp	//신체부위 :
カキ氷	빙수	1
かぎ爪	갈고리손톱	1
カクゴ	각오	1
カクレンボ	숨바꼭질	1
かくれんぼ	숨바꼭질	1
カケラ	파편	1
カゴメカゴメ	숨바꼭질	1
かすてら	카스테라	1	VFd	//음식(음료) :
かすり傷	찰과상	1	UTi	//질병 :
カセットコンロ	휴대용버너	1
カタコリ	어깨결림	1
カタストロフィ	캐타스트로피	1
カタマリ	덩어리	1
カチコミ	쳐들어감	1
ガチンコ	진검승부	1
カツカレー	돈까스카레	1	VFd	//음식(음료) :
カットソー	니트	1	VCp	//의복
カップラーメン	컵라면	1	VFd	//음식(음료) :
ガニ股	O형 다리	1
カボチャ頭	호박머리	1
ガマン汁	쿠퍼액	1	VLu	//분비물
カミングスーン	커밍순	1
カモフラージュ	캐모플라지	1
カラクリ	장치	1
カラシニコフ	칼라시니코프	1	VTw	//무기 :
カラスの行水	고양이 세수	1
がらんどう	텅 빔	1
カラ笑い	헛웃음	1
カリオストロ	칼리오스토르	1
カレーラーメン	카레라면	1	VFd	//음식(음료) :
ガレオン	갈레온	1
カンシャ	감사	1
カントリー	컨트리	1
カンペ	큐 카드	1
ガン見	뚫어지게 봄	1
キィック	킥	1
キープ	킵	1
キオク	기억	1
キオクソウシツゥ	기억상실	1
キセイジジツ	기정사실	1
きそうてんがい	기상천외	1
キットカット	킷켓	1
きつね色	옅은 갈색	1	UCr	//색상
キマリ	결정	1
キモチ	기분	1
ギャグボール	재갈볼	1
ギャグマンガ	개그만화	1
キャッシュカード	캐쉬카드	1
キャディラック	캐딜락	1
キャバクラ	캬바쿠라	1
キャメロン	카메론	1
ギャルゲ	걸게임	1
キューティ	큐티	1
キョーミ	흥미	1
ギリセーフ	아슬아슬 세이프	1
ギロチン	길로틴	1
キンチョー	긴장	1
きんつば	킨츠바	1
クィックセーブ	퀵세이브	1
クィン	퀸	1	//가타카나 발음을 위한 것
クウォークス	쿼크스	1
クールフェイス	쿨페이스	1
グゥレィト	그레이트	1
クグツ	꼭두각시	1
クサヤ	말린 자반고등어	1	VFd	//음식(음료) :
くずきり	쿠즈키리	1
クズッ	쓰레기	1
くすみ	칙칙함	1	UCr	//색상
クソゲー	쿠소게임	1
くそ度胸	똥배짱	1
グッジョブ	굿잡	1
くらいまっくす	클라이막스	1
クラストップ	클래스톱	1
すとっぷ	스톱	1
クリア	클리어	1
クリアッ	클리어	1
クリーム	크림	1
クリエイト	크리에이트	1
クリック	클릭	1
クリッスマーッス	크리스마스	1
クリティカル	크리티컬	1
クリトリス	클리토리스	1	VBp	//신체부위 :
グリム	그림	1	//가타카나 발음을 위한 것
くるみ割り	호두까기	1	VPe	//도구
グレートブリテン	그레이트 브리튼	1
クローゼット	클로젯	1
クロワッサン	크로와상	1	VFd	//음식(음료) :
クンニリングス	커닐링구스	1	UTt	//기술
ケイケン	경험	1
ケイレン	경련	1	UTi	//질병 :
ゲーセン	게임센터	1	VPl	//장소 :
ゲームセッ	게임셋	1
ケシズミ	숯	1
ケジメ	구별	1
ケツ	엉덩이	1	VBp	//신체부위 :
ケッコン	결혼	1
ケッサク	걸작	1
けってーい	결-정	1	//「じゃ、けってーい！　行こ、行こ、リエのお兄ちゃん♪」
ケツの穴	엉덩이 구멍	1	VBp	//신체부위 :
ケツマン	항문보지	1	VBp	//신체부위 :
ケツマンコ	항문보지	1	VBp	//신체부위 :
ケツ穴	똥구멍	1	VBp	//신체부위 :
ゲテパン	맛없는 빵	1	VFd	//음식(음료) :
ゲテモノ	조잡한 물건	1
ケムリ	연기	1
ケモノ耳	동물귀	1	VBp	//신체부위 :
ゲンカ	싸움	1
けんちん汁	맑은 장국	1	VFd	//음식(음료) :
ゲンナリ	짜증	1
ケンポウ	권법	1	UTt	//기술
コイゴコロ	연정	1	UFl	//감정
コインロッカー	코인 락커	1
コウエン	공원	1	VPl	//장소 :
コウビ	교미	1
ゴーカート	고카트	1
ゴースト	고스트	1
コクハク	고백	1
コクピット	콕피트	1	VPl	//장소 :
ここいら	이 근처	1	VPl	//장소 :
ここら辺	이 근처	1	VPl	//장소 :
ココロ	마음	1
ゴコロ	마음	1
コスチューム	코스츔	1	VCp	//의복
コタツ	코타츠	1
ごちゃ混ぜ	뒤섞인 덩어리	1
コチュジャン	고추장	1	VFd	//음식(음료) :
コックピット	콕피트	1	VPl	//장소 :
ごっこ遊び	흉내놀이	1
こっちのほう	이쪽	1	UDr	//방향
こっぱみじん	산산조각	1
ことの次第	일의 형편	1
コネクション	커넥션	1
コネクタ	커넥터	1
コネクト	커넥트	1
ごはーん	밥	1	VFd	//음식(음료) :
コボルト	코볼트	1
コマーシャル	커머셜	1
ゴマカシ	속임수	1
コマ落とし	빨리감기	1
ゴムマリ	고무공	1	VRw	//놀이기구
こむら返り	장딴지 근육경련	1	UTi	//질병 :
コメカミ	관자놀이	1	VBp	//신체부위 :
コメット	코멧	1
ゴルド	골드	1
これっきり	이것 뿐	1
コロシアム	콜로세움	1	VBl	//건축물
コロッセオ	콜로세움	1	VBl	//건축물
コンクール	콩쿠르	1
コンクリートブロック	콘크리트 블록	1
コンクル	콩쿨	1
コンセプト	컨셉	1
コンソメ味	콩소메맛	1	UYa	//맛(미각) :
コンティニュー	컨티뉴	1
コンバージョン	컨버전	1
コンバート	컨버트	1
コンバット	컴뱃	1
コンパニオン	컴퍼니언	1
コンパルソリ	컴펄서리	1
コンビニ	편의점	1	VPl	//장소 :
コンビニエンスストア	컨비니언스 스토어	1	VPl	//장소 :
コンビニメシ	편의점밥	1	VFd	//음식
コンプリート	컴플릿	1
コンプレッサー	컴프레셔	1
コンボ	콤보	1
ご構いなし	상관없음	1
ご飯茶碗	밥공기	1	VCk	//주방기기
ご用心	주의	1
ザァメン	정액	1	VLu	//분비물
ザーメン	정액	1	VLu	//분비물
ザーメンッ	정액	1	VLu	//분비물
サイアク	최악	1
サイコー	최고	1
サイハイソックス	싸이 하이삭스	1	VCp	//의복
サイレーン	사이렌	1
サシで勝負	맞장승부	1
ザッハトルテ	자허토르테	1
サドル	새들	1
サブジェクト	서브젝트	1
サボタージュ	사보타지	1
サボリ	농땡이	1
サムズアップ	썸즈업	1	//サムズアップしてみせる。
サラきん	융자금	1
サラダ	샐러드	1	VFd	//음식(음료) :
サラ金	융자금	1
サルファ	사르파	1
サルベージ	샐비지	1
さわり心地	만지는 느낌	1	UYt	//촉감
サンオイル	썬오일	1
サンクチュアリ	생츄어리	1
さんせーい	찬성	1
サンダー	썬더	1
サンダル	샌들	1	VCp	//의복
サンドバック	샌드백	1
ザンネン	유감	1	UFl	//감정
ざんばらの髪	산발한 머리	1
さ来年	내후년	1	UMe	//시간 :
シアトリズム	시어터리즘	1
シーコッコ	쉬야	1	VLu	//분비물
シード	시드	1
シェイク	쉐이크	1
シェイド	쉐이드	1
ジエータイ	자위대	1	VGt	//집합(군집)
ジェットコースター	제트 코스터	1	VTp	//교통수단
ジェントル	젠틀	1
シガラミ	얽매임	1
シキタリ	관습	1
シグルイ	시구루이	1
シゴキ	잡아당김	1
シシトウ	꽈리고추	1	VPt	//식물 :
しっぱ～い	실~패	1
シツレー	실례	1
ジト目	반쯤 뜬 눈	1	VBp	//신체부위 :
シナモン	시나몬	1
シノプス	시놉스	1
シボ	잔주름	1
シャーペン	샤프	1
シャイ	샤이	1	UYi	//내적 형용 :
ジャガイモ	감자	1	VFdVPt	//음식, 식물
シャケ缶	연어캔	1	VFd	//음식 : いわゆるシャケ缶である。
ジャスティス	저스티스	1
シャットダウン	셧다운	1
シャッフル	셔플	1
しゃぶりっぷり	빠는 모습	1
ジャマ	방해	1
ジャンク	정크	1
ジャンケンポンッ	가위바위보	1
シュウリョ	종료	1
しゅっぱ～つ	출~발	1
しょういんしん	소음순	1	VBp	//신체부위 :
ジョウロ	물뿌리개	1
ジョーカー	조커	1
ジョーダン	농담	1
ジョギング	조깅	1
じょせいほるもん	여성호르몬	1	VLu	//분비물
ジョッキ	맥주잔	1
ショットガン	샷건	1	VTw	//무기 :
ショルダーチャージ	숄더챠지	1	UTt	//기술
ションベン	소변	1	VLu	//분비물
シルバーソード	실버소드	1	VTw	//무기 :
シルバーボウ	실버보우	1	VTw	//무기 :
しわ	주름	1
しわざ	소행	1
シンニュウ	침입	1
シンパシィ	sympathy	1
ジンマシン	두드러기	1
スイーツ	스위트	1
スィート	스위트	1
スーパーバイキング	슈퍼바이킹	1
すきゃんだる	스캔들	1
スクリュー	스크류	1
スクリュードライバ	스크류드라이버	1	VPe	//도구
スケイルアーマー	스케일 아머	1	VCp	//의복
スゴ腕	굉장한 솜씨	1
スタ～ト	스타~트	1
スターダスト	스타더스트	1
スッカラカン	빈털털이	1
すっからかん	빈털털이	1
すっぽんぽん	알몸	1
ストーキング	스토킹	1
ストーン	스톤	1
ストリーム	스트림	1
ストレッチ	스트레치	1
ストローク	스트로크	1
スパート	스퍼트	1
スパンキング	스팽킹	1	UPp	//상&벌
スプラッタ	스플래터	1
スプリンクラー	스프링쿨러	1
スペルマ	스펌	1	VLu	//분비물
スポォツ	스포츠	1
スポット	스팟	1
すましヅラ	새침한 척	1
スマホ	스맛폰	1
ズリネタ	자윗거리	1
スレイヤ	슬레이어	1
すれっからし	닳고 닳음	1	UYi	//내적 형용 :
寸でのところ	위기의 순간	1	UMe	//시간 :
すんでの所	위기의 순간	1	UMe	//시간 :
セイエキ	정액	1	VLu	//분비물
セーエキ	정액	1	VLu	//분비물
せーえき	정액	1	VLu	//분비물
セーフッ	세이브	1
セオリー	씨어리(theory)	1
せかいせいふく	세계정복	1	//「せかいせいふくのだいいっぽ、だね」
セカンドチップ	세컨드칩	1
セクシィ	섹시	1	UYh	//외적 형용
セクスィー	섹시	1	UYh	//외적 형용
セっクス	섹스	1
せっくす	섹스	1
セフティ	세이프티	1
セミロング	세미롱	1
セレブ気分	유명인 기분	1
ゾウキン	걸레	1
ソウシツ	상실	1
ソウル	소울	1
ソーサー	받침접시	1
ソード	소드	1	VTw	//무기 :
そよ風	산들바람	1
そら耳	환청	1	UHr	//음성(음향)
ソルジャーオブフォーチューン	솔져오브포츈	1
ソンザイ	존재	1
ターイムストープ	타임스톱	1
ダージリンティー	다르질링티	1	VFd	//음식(음료) :
だいいっぽ	제 1보	1	//「せかいせいふくのだいいっぽ、だね」
ダイガク	대학	1	VPl	//장소 :
タイホ	체포	1
タイムラグ	타임랙	1
タイムリープッ	타임리프	1
タイヤキ	붕어빵	1	VFd	//음식(음료) :
ダイングメッセージ	다잉 메세지	1
ダガー	대거	1	VTw	//무기 :
たこやき	타코야키	1	VFd	//음식(음료) :
ダジャレ	시시한 익살	1
ダダ	다다	1
タダ働き	무료봉사	1
たて筋	외음부[縱筋]	1	VBp	//신체부위 :
ダテ眼鏡	겉멋 안경	1
タトゥー	타투	1	VSp	//그림
ダブルミスコン	더블 미스 콘테스트	1
たまごやき	달걀부침	1	VFd	//음식(음료) :
タマ蹴り	불알차기	1	UTt	//기술
タメ口	반말	1
ダメ出し	지적	1
だめ出し	지적	1
駄目出し	지적	1
タラコ	명란젓	1	VFd	//음식(음료) :
タレ目	쳐진 눈	1	VBp	//신체부위 :
たんじょうび	생일	1
たんじょーび	생일	1
ダンジョン	던전	1	VPl	//장소 :
たんぽぽ	민들레꽃	1	QAL	//꽃이름(풀이름)
タンメン	탕면	1	VFd	//음식(음료) :
チ○チン	자지	1	VBp	//신체부위 :
チ○ポ	자지	1	VBp	//신체부위 :
ち○ぽ	자지	1	VBp	//신체부위 :
チームカラー	팀컬러	1
チェックメイト	체크메이트	1
チカラ	힘	1
チコク	지각	1
チャーンス	찬스	1
チャイム	챠임	1
ちゃんこ鍋	쨩코나베	1	VFd	//음식(음료) :
ちゃんねる	채널	1
チャンバラ	칼싸움	1
チョウアンコク	초암흑	1
チョップ	춉	1
ちょっぷ	춉	1
チリトリ	쓰레받이	1	VPe	//도구
ちりとり	쓰레받이	1	VPe	//도구
チンクシャ	못난 얼굴	1	VBp	//신체부위 :
チングリ返し	チングリ返し	1	UTt	//기술
ちんぐり返し	ちんぐり返し	1	UTt	//기술
ちんぽ	자지	1	VBp	//신체부위 :
ツア	투어	1
ツインズ	트윈스	1
ツインテ	트윈테일	1
ツインテール	트윈테일	1
ツキモノ	부수물	1
ツッコミ	츳코미	1
ツッコム	츳코미	1
つばめ返し	쯔바메가에시	1	UTt	//기술
ツムジ	가마	1
ツモ	츠모	1
ツラ構え	상판떼기	1	VBp	//신체부위 :
つら構え	상판떼기	1	VBp	//신체부위 :
ツルペタ	절벽가슴	1	VBp	//신체부위 :
ツンデレ	츤데레	1
つんぼの早耳	귀머거리의 지레짐작	1
ティーカップ	티컵	1
ティーバッグ	티백	1
ディープスロート	딥스로트	1
ディスティニー	데스티니	1
ティッシュ	티슈	1
ディティール	디테일	1
ディバイダー	디바이더	1
ディバインブロック	디바인블록	1
テイム	팀	1	VGt	//집합(군집)
ディルド	딜도	1	VPe	//도구
ディルドー	딜도	1	VPe	//도구
ティンクル	트윙클	1
デエト	데이트	1
デカチンポ	왕자지	1	VBp	//신체부위 :
デカパイ	왕가슴	1	VBp	//신체부위 :
デカマラ	왕자지	1	VBp	//신체부위 :
でか乳	왕젖	1	VBp	//신체부위 :
でか乳輪	큰 유륜	1	VBp	//신체부위 :
舌の根	혀뿌리	1	VBp	//신체부위 :
漬物石	누름돌	1
できもの	종기	1
てくにっく	테크닉	1	UTt	//기술
デコピン	핑거펀치	1
デジカム	디지털캠코더	1
デジタルヴィデオカメラ	디지털 비디오카메라	1
デジャヴ	데자뷰	1
デジャブ	데자뷰	1
デジ物	디지털물	1
テッィシュ	티슈	1
デフォルメ	데포르메	1
デモンストレイション	데몬스트레이션	1
デュエル	듀얼	1
テラー	테러	1
デリート	딜리트	1
デリカシー	델리커시	1
テリトリー	테리토리	1
デリヘル	출장마사지	1
テレパスィー	텔레파시	1
テレ隠し	수줍음 감추기	1
デンキ	전기	1
デンジャラス	데인져러스	1
テンション	텐션	1
デンプシーロール	뎀프시롤	1	UTt	//기술
テンペスト	템페스트	1
ドアノブ	문손잡이	1
トゥ	투	1
トゥイン	트윈	1
トーサツ	도촬	1
ドール	돌	1
トカレフ	토카레프	1	VTw	//무기 :
ドキュメント	도큐멘트	1
ドグラマグラ	도구라 마구라	1
ドタキャン	직전 취소	1
ドック	도크	1
ドッジボール	피구	1
ドッヂボール	피구	1
ドット	도트	1
トップレス	탑리스	1	VCp	//의복
ドツボ	분뇨통	1
とっ外れ	맨 끝	1	VPl	//장소 :
ドネルケバブ	도네르케밥	1	VFd	//음식(음료) :
とびっきり	최상	1
とも綱	밧줄	1
ドヤ顔	의기양양한 얼굴	1	VBp	//신체
ドライアイ	안구건조증	1	UTi	//질병 :
ドライバーユニット	드라이버 유닛	1
トラバント	트라번트	1
ドラムロール	드럼롤	1
ドリアン	두리안	1	QAM	//과일명
トレジャー	트레져	1
トロピカルレモネーズ	트로피컬 레모네이즈	1
トンカチ	쇠망치	1	VPe	//도구
ドングリ	도토리	1	QAM	//과일명
ナーバス	nervous	1
ナイショ	비밀	1
ナイトメア	나이트메어	1
ナイン	나인	1
ナカ出し	질내사정	1
ナチュラルボーン	네츄럴 본	1
ナットウ	낫토	1	VFd	//음식(음료) :
ナットー	나토	1
なに食わない顔	새침한 얼굴	1	VBp	//신체부위 :
なに食わない態度	새침한 태도	1
ナフキン	냅킨	1
ナマ脚	생다리	1	VBp	//신체부위 :
ナミダ	눈물	1	VLu	//분비물
ナンバーディスプレイ	넘버 디스플레이	1
なんべん	몇 번	1	//なんべんとなく往復した
ニーベルング	니벨룽	1
ニオイ	냄새	1	UYm	//냄새(후각)
におーい	냄새	1	UYm	//냄새(후각)
ニケツ	동승	1
ニヤケ面	웃는 얼굴	1	VBp	//신체부위 :
にらめっこ	노려보기	1
ヌイグルミ	인형	1
ヌーヨーク	뉴욕	1	QCTVPl	//장소, 지명 :
ぬめり気	미끌한 느낌	1
ネコババ	도둑질	1
ネコミミ	고양이귀	1	VBp	//신체부위 :
ネタ元	출처	1
ネックレス	넥클리스	1
ネトゲ	넷게임	1
ネトラレ	네토라레	1
ネトリ	네토리	1
ネバーエンディング	네버엔딩	1
ノヴェル	노벨	1
ノーブラッ	노브라	1
ノゾキ	엿보기	1
ノックアウト	넉아웃	1
ノブレス	노블레스	1
ノリアクション	노리액션	1
ノリツッコミ	노리츳코미	1
ノロケ	배우자 자랑	1
ノロケ話	주책스런 이야기	1
ノンジャンル	비[非]장르	1
パーソナリティ	퍼스널리티	1
ハードコア	하드코어	1
バーニング	버닝	1
パーフェクトハーモニック	퍼펙트 하모닉	1
パーフェクトヘヴン	퍼펙트 헤븐	1	VPl	//장소 :
ハーブティ	허브티	1	VFd	//음식(음료) :
ハーベスト	하베스트	1
バームクーヘ	바움쿠헨	1
ハーモニック	하모닉	1
ハーレム	하렘	1
バーンジー	번지	1
ハイエンド	하이엔드	1
ハイキック	하이킥	1	UTt	//기술
ハイクラス	하이클래스	1
ハイコストパフォーマンス	하이코스트 퍼포먼스	1
バイト	아르바이트	1
パイパン	백보지	1	VBp	//신체부위 :
パイパンマンコ	백보지	1	VBp	//신체부위 :
ハイヤー	전세 자동차	1	VTp	//교통수단
ハウター	하우터	1
バオバブ	바오밥	1
ハカイ	파괴	1
ばか面	멍청한 얼굴	1	VBp	//신체부위 :
バクダン	폭탄	1	VTw	//무기 :
ハシゴ	사다리	1
バズーカ	바주카	1	VTw	//무기 :
ハタキ	먼지떨이	1	VPe	//도구
ハタチ	스무살	1
バック	백	1
バックアップ	백업	1
バックステップ	백스텝	1	UTt	//기술
バックドロップ	백드롭	1	UTt	//기술
バツグン	발군	1
パッケ	패키지	1
パッケージ	패키지	1
バッタアウッ	타자 아웃	1
バッテラ	고등어초밥	1	VFd	//음식(음료) :
バッテン	벌점	1
バット	배트	1
ハッピーエンド	해피엔드	1
ハッピーバースデー	해피 버스데이	1
ハッピバースデートゥーユー	해피 버스데이 투 유	1
ハツラツ	발랄	1
バトルアックス	배틀엑스	1	VTw	//무기 :
ハナシ	이야기	1
パニク	패닉	1
パニックもの	패닉물	1
ハネムーン	허니문	1
パパイア	파파야	1
ハピネス	해피네스	1
ハラキリ	할복	1
バラストタンク	밸러스트탱크	1
ハラボテ	불룩해진 배	1	VBp	//신체부위 :
バリア	배리어	1
ハリセンボン	침 1000개	1
パワハラ	직장내 괴롭힘	1
ハンケチーフ	손수건	1
ハンザイ	범죄	1
バンソウコウ	반창고	1
ハンターズ	헌터즈	1
ハンターボウ	헌터보우	1	VTw	//무기 :
ぱんつ	팬티	1	VCp	//의복
パンツー	팬티	1	VCp	//의복
パンティ	팬티	1	VCp	//의복
ハンデキャップ	핸디캡	1
ハンドガン	핸드건	1	VTw	//무기 :
ピアス	피어스	1
ピアッシング	피어싱	1
ピース	피스	1
ヒートアップ	히트업	1
ビールビン	맥주병	1
ヒゲ	수염	1
ひじ鉄	팔꿈치치기	1	UTt	//기술
ひだひだ	주름들	1
ビックリカメラ	몰래카메라	1
ひとつ部屋	한 방	1	VPl	//장소 : ひとつ部屋の中で暮らしていれば
ひと周り	한 바퀴	1
ひと周り年上	12살 연상	1
ひと周り年下	12살 연하	1
ひと皮	한 가죽	1
ひと夏	어느 여름	1
ヒンシュク	빈축	1
ファイト	파이트	1
ファイナルファンタジ	파이널 판타지	1
ファッションショー	패션쇼	1
フィーチャリング	피쳐링	1
フィギュア	피규어	1
フイスラブ	사내연애	1
フィニッシュ	피니쉬	1
フィフティフィフティ	50 : 50	1
フェティシズム	페테시즘	1
フェラチオ	펠라치오	1	UTt	//기술
ブカケ	부카케	1
ふくれっ面	뾰로통한 얼굴	1	VBp	//신체부위 :
ブザー	부저	1
ふたぁつ	둘	1
ブラごし	브라 너머	1
ブラスト	블래스트	1
プラナリア	플라나리아	1
プラネタリウム	플라네타리움	1
フリーダム	프리덤	1
ブリーフケース	서류 가방	1
ブルックリン	브룩클린	1	QCTVPl	//장소, 지명 :
フルフェイスヘルメット	풀페이스 헬멧	1	VCp	//의복
ブルマー	부르마	1	VCp	//의복
ブレイカ	브레이커	1
ブレイカー	브레이커	1
ブレイジング	블레이징	1
ブレイブ	브레이브	1
フレイム	플레임	1
プレース	프레스	1
ブレード	블레이드	1
プレッシャ	프레셔	1
プレッシャー	프레셔	1
フレンドリー	프렌들리	1
フレンドリスト	프랜드 리스트	1
ブログ	블로그	1
ページ目	페이지째	1
へっぽこぶり	서투른 꼴	1	UYh	//외적 형용
ヘドバン	헤어밴드	1
ポインター	포인터	1
ボーイッシュ	보이쉬	1	UYh	//외적 형용
ポーション	포션	1
ホットケーキ	핫 케익	1	VFd	//음식(음료) :
ホムンクルス	호문쿨루스	1
ホラー	호러	1
ホルスタ	홀스터	1
ホルスター	홀스터	1
ボロ家	고물집	1	VPl	//장소 :
ボンデージ	본디지	1
ボンボン	봉봉	1
マ○コ	보지	1	VBp	//신체부위 :
マイノリティー	마이너리티	1
マジギレ	진짜 열받음	1
マジックアイテム	매직아이템	1
マシュマロ	머시멜로우	1	VFd	//음식(음료) :
マジョリティー	마조리티	1
マシンガン	머신건	1	VTw	//무기 :
ますこっと	마스코트	1
マゾっ気	마조끼	1	UYi	//내적 형용
マニアック	매니악	1	UYi	//내적 형용 :
マンカス	보지 각질	1
マンガ喫茶	망가킷사	1
マングリ返し	굴곡위	1	UTt	//기술
まんぐり返し	굴곡위	1	UTt	//기술
ミートスパ	미트스파	1
みぞおち	명치	1	VBp	//신체
ミリョク	매력	1	UYi	//내적 형용
ムーディー	무디[moody]	1
ムーンストーン	문스톤	1
ムテキ	무적	1
メス穴	암컷구멍	1	VBp	//신체부위 :
メタノール	메탄올	1
メテオ	메테오	1
メルアド	메일주소	1
メンタリティ	멘탈리티	1
メンテナンス	메인터넌스	1
もちつもたれつ	상부상조	1
モテ期	인기있는 시기	1
モロ出し	그대로 냄	1
もろ出し	그대로 냄	1
モンゴル	몽골	1	QCTVPl	//장소, 지명 :
ヤケ食い	폭식	1
ヤセがまん	오기	1	UFl	//감정
ヤセ我慢	오기	1	UFl	//감정
やせ我慢	오기	1	UFl	//감정
やぶ蛇	긁어 부스럼	1
やましこと	꺼림칙한 일	1
やらされ感	시켜지는 느낌	1
やり過ぎのきらい	너무 심한 경향	1
ユーフォーキャッチャー	인형뽑기	1
ユーフォリア	유포리아	1
ゆうわく	유혹	1
ゆーわく	유혹	1
よがり汁	환희의 즙	1	VLu	//분비물
ヨクボウ	욕망	1	UFl	//감정
ヨダレ	군침	1	VLu	//분비물
ヨロコビ	기쁨	1	UFl	//감정
ラヴリィ	러블리	1
ラクガキ	낙서	1	VSp	//그림
ラグビ	럭비	1
ラジャ	라져	1
ラッキ	럭키	1
ラブコメ	러브코미디	1
ランドセル	란도셀	1
リアルレジェンド	리얼 레전드	1
リーダシップ	리더십	1	UYi	//내적 형용
リッパー	래퍼	1
リフレイン	리프레인	1
ルナティック	루나틱	1
レイアー	레이어	1
レイピア	레이피어	1	VTw	//무기 :
レヴェル	레벨	1
レヴォリューション	레볼루션	1
レジデンス	레지던스	1
レッテル	라벨	1
レパートリー	레파토리	1
ロウソク	양초	1
ローキック	로우킥	1	UTt	//기술
ローズウッド	로즈우드	1
ローテンション	로우 텐션	1
ロシアンルーレット	러시안 룰렛	1
ロッカ	로커	1
ロッカー	로커	1
ワイセツ	외설	1
ワガマ	어리광	1
ワラビモチ	고사리떡	1	VFd	//음식(음료) :
ワレメ	균열	1
ワンダーランド	원더랜드	1
家じゅう	집안 구석구석	1	VPl	//장소 :
苛め甲斐	괴롭히는 보람	1	UFl	//감정
家ん中	집 안	1	VPl	//장소 :
街頭	가두[街頭]	1
加齢臭	홀애비 냄세	1	UYm	//냄새(후각)
駕籠	가마	1	VTp	//교통수단
歌向き	노래 취향	1
角突撃	뿔돌격	1
脚立	접사다리	1
竿肌	음경표피	1	VBp	//신체부위 :
肝試し	담력시험	1
懇願	간원	1
甘え癖	응석부리는 버릇	1
甘え声	응석부리는 소리	1
堪え症	참을성	1
感じ方	느끼는 방법	1
坩堝	도가니	1
甘噛み	살짝 깨물기	1
あま噛み	살짝 깨물기	1
感無量	감개무량	1
甘酢	감초	1	VFdVPt	//음식, 식물
甲斐性	생활력	1
降りどき	내릴 때	1	UMe	//시간 : 体調不良を訴えて教室を去る、いわば降りどきを失ったその行き着く果ては……。
強気ぶり	강한 척	1
腔内	몸속	1
岡場所	사창가	1
開けた場所	열린 장소	1	VPl	//장소 :
開脚	개각[開脚]	1
鎧甲	갑옷	1	VCp	//의복
鎧兜	투구	1	VCp	//의복
鎧衣	요로이	1
開錠	개정[開錠]	1
据え膳	차린 밥상	1
居眠り	깜빡 졸음	1
巨乳	거유	1	VBp	//신체부위 :
居住区	거주구	1	VPl	//장소 :
鍵型	자물쇠형	1
怯えの表情	두려움의 표정	1	UYh	//외적 형용 :
掲げられた額	내걸려진 간판	1	//掲げられた額には、『成由神社』と記してあった。
激サム	격하게 추움	1
激写	격사[激寫]	1
激辛	격신[激辛]	1	UYa	//맛(미각) :
見せあいっこ	서로 보여주기	1
見せしめ	본보기	1	UPp	//상&벌 : 神を疑う者への見せしめとして
見せっこ	서로 보여주기	1
見せ物小屋	가설극장	1	VPl	//장소 :
見た目	겉모습	1
肩紐	어깨끈	1	VCp	//의복
見得	포즈[見得]	1
犬笛	호루라기	1
決壊	결궤[決壞]	1
鎌首	굽은 목	1	VBp	//신체부위 :
鎌鼬	카마이다치	1
警戒体勢	경계자세	1
軽口	농담	1
軽音部	경음악부	1
驚天動地	경천동지	1
鯨型	고래모양[鯨型]	1
驚喜	뜻밖의 기쁨[驚喜]	1	UFl	//감정
稽古中	연습중	1
考え方	사고방식	1
叩き台	원안	1
尻たぶ	엉덩이살	1	VBp	//신체부위 :
尻の穴	엉덩이 구멍	1	VBp	//신체부위 :
股間	사타구니	1	VBp	//신체부위
高見	고견	1
苦境	곤경	1
高機動	고기동	1
苦労のし甲斐	고생하는 보람	1	UFl	//감정
苦鳴	괴로운 울음	1
古武術	고무술	1	UTt	//기술
古傷	오랜 상처	1	UTi	//질병 :
苦手教科	못하는 과목	1
苦手意識	못한다는 의식	1
尻拭い	뒷치닥거리	1
股奥	가랑이 속	1	VPl	//장소 :
尻肉	엉덩이살	1	VBp	//신체부위 :
袴姿	하카마 차림	1
苦節	고절[苦節]	1
股座	가랑이	1	VBp	//신체부위 :
告知箱	통지함	1
尻振り	엉덩이 흔들기	1
股布部分	사타구니 부분	1	VBp	//신체부위 :
尻穴	엉덩이구멍	1	VBp	//신체부위 :
苦況	괴로운 상황	1
骨張った手	앙산한 손	1	VBp	//신체 : 骨張った手で優しく彼は彼女の頬を撫でた。
骨張った指	앙상한 손가락	1	VBp	//신체 : でも硬く骨ばった指は少し痛いです。
骨壺	납골 항아리	1
空のペットボトル	빈 패트병	1
空の杯	빈 잔	1
攻めどき	공격할 때	1	UMe	//시간 : ここが攻めどきだと見て、俺はぐっと鮎美に一歩近づいていく。
共同戦線	공동전선	1
恭順	공순[恭順]	1
恐縮	황송	1
串肉	꼬치고기	1	VFd	//음식(음료) :
過ぎるきらい	지나친 경향	1
寡聞	과문[寡聞]	1
慣れっこ	익숙해진 일	1
関知	관지[關知]	1
光臨	광림[光臨]	1
狂夢	광몽[狂夢]	1
広野	광야	1	VPl	//장소 :
狂言	미친소리	1
光輝	광휘[光輝]	1
怪訝顔	의아한 얼굴	1	VBp	//신체부위 :
教え甲斐	가르치는 보람	1	UFl	//감정
橋向こう	다리 건너편	1	VPl	//장소 :
口の端	입 끝	1
口の利き方	말투	1
口枷	입마개	1	VCp	//의복
口角	입가	1	VBp	//신체부위 :
亀甲	귀갑	1
球根	구근[球根]	1
口端	입 끝	1
寇掠	약탈	1
久方ぶり	오랜만	1
勾配	경사[勾配]	1
口先	입 끝	1
拘束衣姿	구속의복 모습	1
口奥	목 안	1	VPl	//장소 :
口臭	입냄새	1	UYm	//냄새(후각)
鈎爪	갈퀴	1
菊蕾	국화봉오리	1
菊門	국문[菊門]	1
菊座	국좌[菊座]	1
巻き卵	계란말이	1	VFd	//음식(음료) :
巻き卵き	계란말이	1	VFd	//음식(음료) :
権化	권화[權化]	1	//奴らは欲望の権化となるでしょう
帰宅道	귀가길	1	VPl	//장소 :
鬼神楽	귀신락	1
貴意	귀의[貴意]	1
閨事	성교[閨事]	1
克己	극기	1
極薄	극박[極薄]	1
克服術	극복술	1	UTt	//기술
極太	극태[極太]	1
近隣	근처	1	VPl	//장소 :
根本	근본	1
根負け	근성에 패배	1
根暗	어두운 성격	1	UYi	//내적 형용 :
今頃	지금쯤	1	UMe	//시간 :
今日明日	오늘내일	1
禁制	금지	1
禁親相愛	근친의 사랑	1
急須	사기 주전자	1
急戦	급전[急戰]	1
気の持ちよう	마음가짐	1
寄り道	어디 들르기	1
気遣わし気	신경쓰이는 기분	1
綺麗事	아름다운 일	1
饑死	기사[饑死]	1
奇樹	기이한 나무	1	VPt	//식물 :
騎乗位	승마위	1	UTt	//기술
気弱	심약[氣弱]	1
奇縁	기연[奇緣]	1
奇遇	우연	1
気疲れ	피로	1
寄合	모임	1
機嫌直し	기분전환	1
起火	기화[起火]	1
金の光	금빛	1
金の蔓	돈줄	1
金の毛	금빛 털	1
金の髪	금발	1
金木犀	금목서	1
金砂	금사[金砂]	1
喫茶	찻집	1	VPl	//장소 :
男冥利	남자로 태어난 기쁨	1
男手一つ	남자손 하나	1
男心	남심[男心]	1
男漁り	남자낚시	1
男子校	남학교	1	VPl	//장소 :
南皮	남피	1	QCTVPl	//장소, 지명 :
南郷	난코우	1
納刀	납도[納刀]	1	VTw	//무기 :
内腿	내퇴[內腿]	1
内凶	내숭	1	UYi	//내적 형용
女系	여계[女系]	1
女蕾	여뇌[女℡뇌]	1	//후처리에서 _뇌_ -> 蕾
女冥利	여자로 태어난 기쁨	1
女芯	여심[女芯]	1
女運	여복	1
女肉口	여육구[女肉口]	1	VBp	//신체부위 :
女陰	여음[女陰]	1
女陰口	여음구[女陰口]	1	VBp	//신체부위 :
女陰門	여음문[女陰門]	1	VBp	//신체부위 :
女陰花	여음화[女陰花]	1
女子校	여학교	1	VPl	//장소 :
女汁	여액[女汁]	1	VLu	//분비물
女唇	여순[女唇]	1	VBp	//신체부위 :
女穴	여자구멍	1	VBp	//신체부위 :
女花門	여화문[女肉門]	1	VBp	//신체부위 :
女花肉	여화육[女花肉]	1	VBp	//신체부위 :
女花唇	여화순[女花唇]	1	VBp	//신체부위 :
年嵩	연상	1
年長	연장	1
怒った顔	화난 얼굴	1	VBp	//신체부위
怒濤	노도	1
怒張	노장[怒張]	1
脳みそ	뇌수	1
悩み事	고민스런 일	1
悩乱	뇌란[惱亂]	1
尿孔	오줌구멍	1	VBp	//신체부위 :
尿瓶	요강	1
尿意	오줌 마려움	1
尿穴	오줌구멍	1	VBp	//신체부위 :
泥よけ	흙받이	1
泥船	이선[泥船]	1
泥除け	흙받이	1
茶番	촌극	1
茶番劇	촌극	1
茶漬け	챠즈케	1	VFd	//음식(음료) :
多幸	다행	1
短慮	짧은생각[短慮]	1
当たり所	맞은 곳	1	VPl	//장소 :
当たり外れ	적중과 빗나감	1
大あくび	큰 하품	1
大はやり	대유행	1
大間違い	큰 실수	1
大剛	대강[大剛]	1
大降り	많이 쏟아짐	1
大開脚	대개각[大開脚]	1
大股開き	다리를 크게 벌림	1
大広場	대광장	1	VPl	//장소 :
大橋	대교	1
大内裏	궁궐 구역	1	VPl	//장소 :
大乱闘	대난투	1
大流氷	대유빙[大流氷]	1
大満足	대만족	1
対面座位	대면좌위	1	UTt	//기술
対美少女	대 미소녀	1
大迷惑	대민폐	1	//大迷惑ですっ！
大番	경비조직	1	VGt	//집합(군집)
大変仲	대단한 사이	1
大本営	대본영	1	VGt	//집합(군집)
大三角	대삼각	1
大箱	큰 상자	1
大上段	대상단[大上段]	1
大勢力	대세력	1
大手	큰 손	1
大時計	대시계	1
大岩	대암[大岩]	1
大音響	대음향	1	UHr	//음성(음향) :
大人数	많은 사람	1
大任	대임[大任]	1
大前進	대전진	1
大正解	정답	1
大進歩	대진보	1
大草原	대초원	1
大治療	대치료	1
大通路	큰 통로	1	VPl	//장소 :
大八車	큰짐수레	1	VTp	//교통수단
大捕物	대대적인 범인체포	1
大嘘	큰 거짓말	1
大協力	대협력	1
大好物	좋아하는 것	1
大和	야마토	1
大火炎	대화염	1
逃げ場所	도망갈 장소	1	VPl	//장소 :
桃尻	분홍 엉덩이	1	VBp	//신체부위 :
道難	도난[道難]	1
道理	도리	1
刀傷	도상[刀傷]	1	UTi	//질병 :
桃色	분홍색	1	UCr	//색상
桃園館	도원관	1	VPl	//장소 :
島中	도중[島中]	1
桃唇	분홍 입술	1	VBp	//신체부위 :
倒錯	도착[倒錯]	1
倒錯症	도착증	1
毒見	독견[毒見]	1
毒舌	독설	1
豚鍋	부타나베	1	VFd	//음식(음료) :
働き甲斐	일하는 보람	1	UFl	//감정
働き盛り	한창 일할 나이	1
動悸	심장의 두근거림	1
冬木立	겨울숲	1	VPl	//장소 :
同部屋	같은 방	1	VPl	//장소 :
錬成	연성	1	UTt	//기술
同室	동실[同室]	1	VPl	//장소 :
同意見	같은 의견	1
疼痛	동통[疼痛]	1
東海	동해	1	VPl	//장소 :
臀部	둔부	1
遁走	도주	1
得意との事	특기라는 일	1	//聖なる民を模すのがとりわけ得意とのこと。
得意料理	자신있는 요리	1	VFd	//음식(음료) :
橙色	주황색	1	UCr	//색상
登城	등성[登城]	1
登坂力	등판력	1
裸絞め	맨손조르기	1	UTt	//기술
落日	석양	1
乱心	난심[亂心]	1
狼藉	행패	1
来船	내선	1
来世	내세	1	VPl	//장소 :
来院	내원	1
両の眼	두 눈	1	VBp	//신체부위 :
両脚	양다리	1	VBp	//신체부위 :
両手のひら	양손바닥	1	VBp	//신체부위 :
良案	양안[良案]	1
両耳	양쪽 귀	1	VBp	//신체부위 :
両足首	양 발목	1	VBp	//신체부위 :
涼風	산들바람	1
諒解	양해[諒解]	1
両脇	양 옆	1	VPl	//장소 :
呂律	말씨	1
麗花	아름다운 꽃	1
力瘤	알통	1	VBp	//신체부위 :
力業	힘쓰는 일	1
連撃	연격	1	UTt	//기술
連射	연사	1	UTt	//기술
猟銃	엽총	1	VTw	//무기 :
霊力	영력	1
霊体	영체	1
零点	영점	1
霊症	영증	1
例え話	비유적인 이야기	1
路肩	갓길	1	VPl	//장소 :
露見	노견[露見]	1
露顕	노현[露顯]	1
聾の早耳	귀머거리의 지레짐작	1
籠城	농성	1
朧衆	오보로슈	1
滝行	폭포수행	1
頼り甲斐	부탁하는 보람	1	UFl	//감정
寮内	기숙사내	1	VPl	//장소 :
涙の粒	눈물 방울	1	VLu	//분비물
涙目	눈물고인 눈	1	VBp	//신체부위 :
柳絮	버들가지	1
流儀	법식	1
流鏑馬	야부사메	1
裏サイト	뒷사이트	1	VPl	//장소 :
裏スジ	성기 뒷부분	1	VBp	//신체부위 :
離れ技	곡예	1
離れ業	곡예	1
裏拳	손등치기	1	UTt	//기술
裏筋	성기 뒷부분	1	VBp	//신체부위 :
里内裏	천황의 임시거처	1	VPl	//장소 :
裏社会	뒷사회	1	VPl	//장소 :
裏山	뒷산	1	VPl	//장소 :
裏生地	안감	1
離縁	이연[離緣]	1
理致	이치	1
裏布	안감	1
隣家	이웃집	1	VPl	//장소 :
隣同士	이웃끼리	1
立ち消え	흐지부지	1
立ち位置	서는 위치	1
立ち姿	서있는 모습	1
馬鹿面	멍청한 얼굴	1	VBp	//신체부위 :
魔糸	마실[魔絲]	1
馬房	마방[馬房]	1
馬上	마상	1
馬小屋	마구간	1	VPl	//장소 :
魔悦	마열[魔悅]	1
魔翼	마익[魔翼]	1
馬場	승마장	1	VPl	//장소 :
鰻登り	자꾸 올라감	1
万倍	만배	1
満悦	만열[滿悅]	1
万札	만엔권	1	VMy	//화폐
亡き後	사후	1
妄想癖	망상벽	1
亡骸	망해[亡骸]	1
埋み火	숯불	1
呆れ顔	기막힌 얼굴	1
毎晩	매일밤	1
妹心	여동생의 마음	1
買出し	구매	1	//俺は明日の弁当の買出しに行ってくるから、
萌え度	모에도	1
猛暑日	무더운 날	1
糸クズ	솜털	1
糸玉	실타래	1
面もち	얼굴	1	VBp	//신체부위 :
眠り顔	잠든 얼굴	1	VBp	//신체부위 :
面構え	상판떼기	1	VBp	//신체부위 :
面倒見	보살핌	1
面白解答	재미있는 해답	1
蔑ろ	업신여김	1	UFl	//감정
命びろい	구사일생	1
命乞い	목숨구걸	1
冥府魔道	명부마도	1
名残	여운	1
酩酊	만취	1
冥土	저승	1	VPl	//장소 :
牡器	수컷성기	1	VBp	//신체부위 :
毛糸	털실	1
毛玉	보풀	1
毛玉取り器	보풀제거기	1	VPe	//도구
牡欲	수컷 욕구	1	UFl	//감정
慕情	사모하는 마음	1	UFl	//감정
牡汁	수컷즙	1	VLu	//분비물
牡臭	수컷냄새	1	UYm	//냄새(후각)
目くばせ	눈짓	1
木っ端	나무 부스러기	1
目の毒	눈의 독[目の毒]	1
睦み言	정담	1
目隠し	눈가리개	1	VCp	//의복
木枝	나뭇가지	1
夢見心地	꿈 같은 기분	1	UYi	//내적 형용 :
猫撫で声	간살스러운 소리	1	UHr	//음성(음향) :
猫用	고양이용	1
猫耳	고양이귀	1	VBp	//신체부위 :
無間地獄	무간지옥	1	VPl	//장소 :
無感心	무감심[無感心]	1
無茶ぶり	터무니 없는 꼴	1	UYh	//외적 형용
無礼講	예의 안 따지는 자리	1
無理筋	무리수	1
無理心中	강제정사	1
無作法	버릇없음	1
拇指	엄지손가락	1	VBp	//신체부위 :
無駄足	헛걸음	1
聞きよう	듣는 방법	1	//フィーナがそう言うならこれ以上聞きようも無かった。
聞き上手	잘 들어주는 타입	1
聞き様	듣는 방법	1	//フィーナがそう言うならこれ以上聞きようも無かった。
文面	글내용	1
文武両道	문무양도	1
味わい深さ	맛의 깊이	1
美脚	미각[美脚]	1	VBp	//신체부위 :
美尻	아름다운 엉덩이	1	VBp	//신체부위 :
媚孔	요염한 구멍	1	VBp	//신체부위 :
米袋	쌀부대	1
未來	미래	1
味蕾	미뢰	1
米粒	쌀알	1
未発達	미발달	1
美声	미성[美聲]	1
未習得	미습득	1
媚薬効果	미약효과	1
米屋	쌀가게	1	VPl	//장소 :
味玉	아지다마[味玉]	1
美腰	미요[美腰]	1	VBp	//신체부위 :
美乳	미유[美乳]	1	VBp	//신체부위 :
媚肉	미육[媚肉]	1	VBp	//신체부위 :
美人局	미인계	1
米一粒	쌀 한톨	1
媚粘膜	오염한 점막	1	VBp	//신체부위 :
美酒	미주[美酒]	1	VFd	//음식(음료) :
眉唾	수상한 것	1
媚穴	요염한 구멍[媚穴]	1	VBp	//신체부위 :
迷惑料	민폐비	1
媚花	요염한 꽃	1
蜜裂	밀열[蜜裂]	1
蜜涙	밀우[蜜淚]	1
蜜液	밀액[蜜液]	1	VLu	//분비물
蜜肉	밀육[蜜肉]	1	VBp	//신체부위 :
蜜汁	밀액	1	VLu	//분비물
蜜穴	밀혈[蜜穴]	1	VBp	//신체부위 :
蜜壺	밀호[蜜壺]	1
泊まり込み	숙박	1	//急な出張や泊まり込みが多い母さんは
縛られ通し	묶여진채	1
泊り込み	숙박	1	//急な出張や泊まり込みが多い母さんは
薄桃色	엷은 분홍색	1	UCr	//색상
薄味	담백한 맛	1	UYa	//맛(미각) :
薄壁	박벽[薄壁]	1
薄生地	얇은 옷감	1
薄闇	얕은 어둠	1
薄暗闇	얕은 어둠	1
薄紙	얇은 종이	1
薄布	박포[薄布]	1
薄紅色	담홍색	1	UCr	//색상
薄黄色	엷은 황색	1	UCr	//색상
返り討ち	역관광	1
半家出	반가출	1
半眼	반쯤 뜬 눈	1
反応炉	반응로	1
返討ち	역관광	1
発作	발작	1	UTi	//질병
放棄	방폐[放棄]	1
放屁	방귀	1
方舟	방주	1	VTp	//교통수단
方向音痴	방향치	1
背もたれ	등받이	1
背面座位	배면좌위	1	UTt	//기술
背凭れ	등받이	1
排便	배변	1
白光	백광[白光]	1
百均	100엔샵	1	VPl	//장소 :
白魔法	백마법	1	UTt	//기술
白銀	백은	1
百人隊	백인대	1	VGt	//집합(군집)
白下着	흰 속옷	1	VCp	//의복
翻弄	번롱[飜弄]	1
罰当たり	벌을 받음	1
罰当り	벌을 받음	1
犯し甲斐	범하는 보람	1	UFl	//감정
変わり様	바뀐 모습	1
変名	가명	1
辺鄙	외진 곳	1	VPl	//장소 :
別腹	다른 배	1	VTp	//교통수단
別世界	이세계	1	VPl	//장소 :
兵糧	군량	1
並木	가로수	1	VPt	//식물 :
併走	병주[倂走]	1
鴇色	연분홍색	1	UCr	//색상
保持	보유	1
普通科	보통과	1
腹ごしらえ	배를 채워둠	1	//ちょっと腹ごしらえしとくか。
腹の肉	뱃살	1	VBp	//신체부위 :
腹巻き	복대	1	VCp	//의복
腹上	배 위	1	VPl	//장소 :
腹上死	복상사	1
腹奥	뱃속	1	VPl	//장소 :
僕的	개인적	1
腹拵え	배를 채워둠	1	//ちょっと腹ごしらえしとくか。
本邸	본저[本邸]	1	VPl	//장소 :
本調子	정상 컨디션	1
棒ちぎり	몽둥이	1	VTw	//무기 :
棒ちぎり木	몽둥이	1	VTw	//무기 :
棒乳切り	몽둥이	1	VTw	//무기 :
付けどころ	붙일 곳	1	VPl	//장소 : 俺の目の付けどころはオッパイだけかいっ！文句の付けどころ
缶ケリ	깡통차기	1
腐れ外道	썩은 외도	1
不見識	분별없음	1
不登校	등교 거부	1
腐乱臭	썩은 냄새	1	UYm	//냄새(후각)
不摂生	폐인생활	1
不信のきらい	불신의 경향	1
部室	부실	1	VPl	//장소 :
不安の種	불안의 씨앗	1
夫人ヅラ	부인 행세	1
不作法	버릇없음	1
不正解	오답	1
鮒鮨	후나즈지	1
父親似	아버지와 닮은 꼴	1
部活動	부활동	1
糞度胸	똥배짱	1
分銅	저울추	1
分銅つき鎖	저울추 달린 사슬	1
憤懣	울분	1	UFl	//감정
体付き	몸매	1	UYh	//외적 형용 :
体操着	체조복	1	VCp	//의복
糞便	대변	1	VLu	//분비물
非の打ち所	나무랄 곳	1
飛びっ切り	최상	1
鼻歌交じり	콧노래를 부름	1
秘口	비구[秘口]	1
秘丘	비구[秘丘]	1	VBp	//신체부위 :
秘窟	비굴[秘窟]	1
秘肌	비기[秘肌]	1	VBp	//신체부위 :
非道	비도[非道]	1
非道徳	비도덕	1
秘洞	비동[秘洞]	1
飛来	비래[飛來]	1
秘裂	비밀의 틈[秘裂]	1	VBp	//신체부위 :
肥溜め	똥구덩이	1
屁理屈	억지소리	1
鼻毛	콧털	1
秘部	비부[秘部]	1
秘部弄り	비부[秘部] 장난	1
秘所	비밀스런 장소	1	VPl	//장소 :
卑語	비어[卑語]	1
鄙語	비어[鄙語]	1
秘奥	비오[秘奧]	1
秘肉	비육[秘肉]	1	VBp	//신체부위 :
非人間的	비인간적	1
非人格的	비인격적	1
非人道	비인도	1
鼻汁	콧물	1	VLu	//분비물
秘唇	비순[秘唇]	1	VBp	//신체부위 :
秘膣	비질[秘膣]	1
飛車角	히샤카쿠	1
秘処	비처[秘處]	1
秘穴	비밀스런 구멍[秘穴]	1	VBp	//신체부위 :
秘壺	비호[秘壺]	1	VBp	//신체부위 :
秘花	비화[秘花]	1
贔屓	편애	1	//후처리의 필요성...?贔屓が多い
牝情	빈정[[牝情]	1
牝汁	암컷즙	1	VLu	//분비물
牝喘ぎ	암컷의 허덕임	1	UHr	//음성(음향) :
牝恥	빈치[牝恥]	1
思いのたけ	더없는 마음	1	// 思いの丈
使い所	사용할 곳	1	VPl	//장소 :
四つん這い	네발로 엎드림	1
四つ這い	네발로 엎드림	1
捨て台詞	일방적인 대사	1
四の字固	4자 굳히기	1	UTt	//기술
斜め上	대각선 위	1	UDr	//방향
斜め下	대각선 아래	1	UDr	//방향
私んち	우리집	1	VPl	//장소 :  ♞俺んち가 필터링으로 바뀜 : 俺んちが嫌なら。
私ンチ	우리집	1	VPl	//장소 :  ♞俺ンチ
私ん家	우리집	1	VPl	//장소 :  ♞俺ん家가 필터링으로 바뀜
砂嵐	모래폭풍	1
四六時中	온종일	1
四歩	네 걸음	1
些事	사소한 일	1
寺社	지사[寺社]	1	VPl	//장소 :
仕事柄	일 관계상	1
思案中	생각 중	1
私怨	개인적 원한	1
射乳	사유[射乳]	1
死合	시합[死合]	1
山高帽	중산모	1	VCp	//의복
産道	산도[産道]	1	VBp	//신체부위 :
産毛	솜털	1
酸味	신맛	1	UYa	//맛(미각) :
山村	산촌	1	VPl	//장소 :
殺戮	살육	1
森ん中	숲속	1	VPl	//장소
三歩	세 걸음	1
三人四脚	3인4각	1
上がり框	문턱	1
上目づかい	눈을 치켜뜸	1
賞味	상미[賞味]	1
相思相愛	상사상애	1
上新粉	멥쌀가루	1
商店街	상점가	1	VPl	//장소 :
商会	상회	1
色気	색기	1	UYh	//외적 형용
色恋	색정	1	UFl	//감정
生きり	생존	1
生歌	생가[生歌]	1	USo	//노래
生脚	생다리	1	VBp	//신체부위 :
生竿	생간[生竿]	1
生甲斐	사는 보람	1	UFl	//감정
生徒会	학생회	1
生足	맨다리	1	VBp	//신체부위 :
生贄	제물	1
西の地平	서쪽의 지평	1
棲家	서가[棲家]	1	VPl	//장소 :
西館	서관	1	VPl	//장소 :
石鍋	돌솥	1
石橋	돌다리	1
石床	돌바닥	1
石化	석화	1
善がり汁	환희의 즙	1	VLu	//분비물
先ッポ	끝 쪽	1	UDr	//방향
先っぽ	끝 쪽	1	UDr	//방향
船底	선저	1
宣伝文句	선전문구	1
先走りの粘液	쿠퍼점액	1	VLu	//분비물
先走りの汁	쿠퍼액	1	VLu	//분비물
先走り汁	쿠퍼액	1	VLu	//분비물
先触れ汁	쿠퍼액	1	VLu	//분비물
旋風脚	선풍각	1	UTt	//기술
舌づかい	혀 사용	1	UTt	//기술
舌なめずり	입맛을 다심	1
舌の先端	혀 끝	1
舌遣い	혀 사용	1	UTt	//기술
舌弄	혀장난	1
舌腹	혓바닥	1	VBp	//신체부위 :
雪山	설산	1	VPl	//장소
繊手	가냘픈 손	1	VBp	//신체부위 :
譫言	헛소리	1
繊指	가냘픈 손가락	1	VBp	//신체부위 :
性関係	성관계	1
星芒	별빛	1
性癖	성벽	1
聖夜	성야	1
聖衣	성의[聖衣]	1	VCp	//의복
城中	성 안	1	VPl	//장소 :
性臭	성취[性臭]	1	UYm	//냄새(후각)
性活	성활	1
蛻の殻	빠져나간 껍질	1
世間的	세속적	1
歳上	연상	1
細首	가는 목	1	VBp	//신체부위
細腰	가는 허리	1	VBp	//신체부위 :
細針	가는바늘	1
細波	잔물결	1
世話焼き	남의 일에 신경씀	1
焼けた鉄	달궈진 철	1
召し物	의복	1	VCp	//의복
小国	소국	1	VPl	//장소 :
小宮殿	소궁전	1	VPl	//장소 :
小部屋	작은 방	1	VPl	//장소 :
小山	작은 산	1	VPl	//장소 :
小傷	작은 상처	1	UTi	//질병
小細工	잔재주	1	UTt	//기술
小水	오줌	1	VLu	//분비물
小躍り	덩실거림	1
掻痒	소양[搔痒]	1
掻痒感	가려운 느낌	1	URc	//지각(인지)
所有物	소유물	1
焼印	낙인	1
素振り	기색	1
小太刀	코타치[小太刀]	1	VTw	//무기 :
松明	횃불	1
送迎	송영[送迎]	1
受け皿	받침접시	1
手コキ	손 애무	1	UTt	//기술
手のひらの震え	손의 떨림	1
手の平の震え	손의 떨림	1
手マン	손 애무	1	UTt	//기술
手みやげ	작은 선물	1
手枷	수갑	1	VAc	//장신구
手脚	팔다리	1	VBp	//신체부위 :
水軍鍋	해물전골	1	VFd	//음식(음료) :
手刀	수도	1	VTw	//무기 :
数度目	몇 번째	1
手篭め	괴롭힘	1
修理代金	수리대금	1
藪蛇	긁어 부스럼	1
穂先	끝	1
獣性	수성[獸性]	1
手々	손가락	1	VBp	//신체부위 :
受信元	수신원	1
首元	목 언저리	1	VPl	//장소 :
狩場	사냥터	1	VPl	//장소 :
水地形	물 지형	1
水責め	물고문	1	UPp	//상&벌 :
獣臭	짐승냄새	1	UYm	//냄새(후각)
収獲	수확	1
熟鮓	나레즈시	1
巡り合せ	운명	1
巡り合わせ	운명	1
順番	순번	1
旬外れ	한물감	1
術式	술식	1
術中	술중	1
虱潰し	철저히 뒤짐	1
膝裏	무릎 뒤	1
膝元	슬하	1
習い事	배우는 일	1
升麻	승마[升麻]	1
縄張り	세력권	1	VPl	//장소 :
縄張り争い	세력 싸음	1
視姦	시간[視姦]	1
時期はずれ	시기 벗어남	1
時期外れ	시기 벗어남	1
示談	합의	1
市立病院	시립병원	1	VPl	//장소 :
矢先のこと	순간의 일	1
食い物	먹을 것	1	VFd	//음식(음료) :
食い扶持	생활비	1	//「ただの仕事だ、食い扶持は誰でも必要だろう？」
息がかる距離	숨이 닿는 거리	1	UXd	//거리
息一つ	숨 하나	1
呻き声	신음소리	1	UHr	//음성(음향) :
新幹線	신칸센	1	VTp	//교통수단
新館	신관	1
身嗜み	몸가짐	1	UYh	//외적 형용 : 身嗜みのチェックを始めた。
神代	신대[神代]	1
神力	신력[神力]	1
神魔界	신마계	1	VPl	//장소 :
身売り	몸팔이	1
神武	진무[神武]	1
神武寺	진무지	1
新部室	레벨	1
身体付き	몸매	1	UYh	//외적 형용 :
辛酸	쓰라림	1
神楽舞	굿춤	1
実年齢	실연령	1
実活動	실활동	1
心配事項	걱정사항	1
心配性	걱정 많은 성격	1
心配顔	걱정스런 얼굴	1	VBp	//신체부위 :
心身一体	심신일체	1
心意気	마음가짐	1
十里	10리	1
十分の一	10분의 1	1	UYr	//(비율) ちょっと前まではその十分の一くらいで買えたのに
十数年	십수년	1
辻演説	가두연설	1
十人隊	십인대	1	VGt	//집합(군집)
辻蹴り	낭심차기	1	UTt	//기술
辻便所	공중변소	1	VPl	//장소 :
双つ	두개	1
双臀	양 엉덩이	1	VBp	//신체부위 :
双乳	양 가슴	1	VBp	//신체부위 :
我慢汁	쿠퍼액	1	VLu	//분비물
悪戯心	장난끼	1	UFl	//감정
安マンション	싸구려 맨션	1	VPl	//장소 :
安眠	안면[安眠]	1
岸壁	안벽[岸壁]	1
安月給	박봉	1
顔前	안전[顔前]	1
暗たん	암담	1
暗闇	어둠	1
闇夜	암야[闇夜]	1
闇雲	암운[闇雲]	1
岩陰	바위 그늘	1	VPl	//장소 :
昂奮	큰 흥분	1	UFl	//감정
愛故	애고[愛故]	1
愛蜜	애밀[愛蜜]	1	VLu	//분비물
愛汁	애액	1	VLu	//분비물
崖下	절벽 밑	1	VPl	//장소 :
厄介事	귀찮은 일	1
腋毛	겨드랑이 털	1	VBp	//신체부위 :
鸚鵡返し	앵무새 흉내	1
桜餅	사쿠라모찌	1	VFd	//음식
桜雲	벚꽃 구름	1
桜吹雪	벚꽃 눈보라	1
桜坂	벚꽃 언덕	1	VPl	//장소 :
桜風	벚꽃 바람	1
夜伽	밤시중	1
夜毎	밤마다	1
野晒し	들에 버려짐	1
夜泣き	밤울움	1	UHr	//음성(음향) :
夜這い	요바이	1
夜天	밤하늘	1
野太刀	야태도	1	VTw	//무기 :
薬袋	약 주머니	1
若竹	어린 대나무	1	VPt	//식물 :
若竹煮	죽순탕	1	VFd	//음식(음료) :
若竹汁	죽순국	1	VFd	//음식(음료) :
薬指	약지	1	VBp	//신체부위 :
痒薬	가려운 약	1	VMd	//약품
御伽噺	옛날 이야기	1
御構いなし	상관없음	1
御心	마음	1
御言葉	말씀	1
御意志	의지	1
御行幸	행차	1
言霊	언령	1
彦星	견우성	1
言葉のあや	멋진 표현	1	//言葉のあやですわ。
俺用	내 전용	1
俺好み	내 취향	1
余熱	여열[余熱]	1
駅弁当	역에서 파는 도시락	1	VFd	//음식(음료) :
駅前通り	역앞 길	1	VPl	//장소 :
縁筋	연줄	1
悦痺れ	기쁨의 저림	1
染み一つ	얼룩 한 점	1
鋭痛	예통[銳痛]	1
奥壁	안벽	1
五歩	다섯 걸음	1
汚棒	오봉[汚棒]	1
五体満足	오체만족	1
五位	5위	1	//五位
温野菜	익힌 야채	1	VFd	//음식(음료) :
完徹	완전 철야	1
腕枕	팔 베게	1
矮小化	왜소화	1
外れの方	변두리 쪽	1	UDr	//방향
腰づかい	허리 사용	1	UTt	//기술
拗ねた表情	토라진 표정	1
腰の振り	허리 흔들기	1	UTt	//기술
揺り籠	요람	1
揺り籃	요람	1
揺籠	요람	1
腰振り	허리 흔들기	1	UTt	//기술
腰布団	포대기	1
憂い顔	슬픈 얼굴	1	VBp	//신체부위 :
右肩	우측 어깨	1	VBp	//신체부위 :
右隣	오른쪽 옆	1	VPl	//장소 :
右目	오른쪽 눈	1	VBp	//신체부위 :
優美	우미[優美]	1	UYh	//외적 형용 :
右膝	오른쪽 무릎	1	VBp	//신체부위 :
右前	좌전[右前]	1
羽織	겉옷	1	VCp	//의복
右向け右	우향우	1
右頬	오른쪽 뺨	1	VBp	//신체부위 :
右胸	오른쪽 가슴	1	VBp	//신체부위 :
雲泥の差	하늘과 땅 차이	1
鬱屈	울적	1
雄マラ	수컷음경	1	VBp	//신체부위 :
元宮廷	원 궁정	1
元中尉	원 중위	1
遠吠え	멀리서 짖음	1
月謝	월사금	1
月謝金	월사금	1
危惧	위구[危懼]	1
癒し系	치유계	1	UYi	//내적 형용 :
揉み心地	주무르는 느낌	1	UYt	//촉감
癒やし	치유	1
柔らかおっぱい	부드러운 젖가슴	1	VBp	//신체부위 :
濡れ染み	젖은 얼룩	1
濡れ音	젖은 소리	1	UHr	//음성(음향) :
乳肌	가슴살	1	VBp	//신체부위 :
幽霊船	유령선	1	VTp	//교통수단
乳輪	유륜	1	VBp	//신체부위 :
油坊主	은대구	1	QAC	//어류
幼少	유소[幼少]	1
柔乳	유유[柔乳]	1	VBp	//신체부위 :
柔肉	유육[柔肉]	1	VBp	//신체부위 :
有刺鉄線	가시철선	1
乳切木	유절목[乳切木]	1
乳搾り	젖짜기	1
肉づき	살집	1	VBp	//신체부위
肉幹	육간[肉幹]	1	VBp	//신체부위 :
肉竿	육봉	1	VBp	//신체부위 :
肉茎	육경[肉莖]	1
肉孔	고기구멍	1	VBp	//신체부위 :
肉塊	고깃덩이	1
肉交	육교[肉交]	1
肉溝	고기틈	1
肉洞	육동[肉洞]	1
肉胴	육봉	1	VBp	//신체부위 :
肉豆	고기콩	1
肉裂	고기틈	1
肉蕾	육뇌[肉℡뇌]	1	//후처리에서 _뇌_ -> 蕾
肉瘤	육류[肉瘤]	1
肉粒	고기 알갱이	1
肉門	육문[肉門]	1	VBp	//신체부위 :
肉襞	고깃주름	1
肉壁	육벽[肉壁]	1	VBp	//신체부위 :
肉棒	육봉	1	VBp	//신체부위 :
肉傘	육산[肉傘]	1	VBp	//신체부위 :
肉床	고기바닥	1
肉線	육선[肉線]	1
肉室	육실[肉室]	1
肉芯	육심[肉芯]	1
肉芽	육아[肉芽]	1
肉圧	육압[肉壓]	1
肉柱	육주[肉柱]	1	VBp	//신체부위 :
肉唇	육순[肉唇]	1	VBp	//신체부위 :
肉膣	육질[肉膣]	1
肉槍	육창[肉槍]	1	VBp	//신체부위 :
肉臭	육취[肉臭]	1	UYm	//냄새(후각)
肉筒	육통[肉筒]	1
肉便器	육변기	1
肉杭	고기말뚝	1	VBp	//신체부위 :
肉穴	고기구멍	1	VBp	//신체부위 :
肉壺	고기단지	1	VBp	//신체부위 :
潤み声	울먹이는 소리	1	UHr	//음성(음향) :
隠し扉	숨겨진 문	1
隠れ場所	숨은 장소	1	VPl	//장소 :
銀鼠色	은서색	1	UCr	//색상
乙女丼	아가씨 덮밥	1	VFd	//음식(음료) :
淫ら腰	음란한 허리	1	VBp	//신체부위 :
淫ら汗	음란한 땀	1	VLu	//분비물
淫器具	음기구[淫器具]	1	VPe	//도구
淫裂	음렬[淫裂]	1	VBp	//신체부위 :
陰門	음문[陰門]	1	VBp	//신체부위 :
淫蜜	음밀[淫蜜]	1	VLu	//분비물
淫辞	음탕한 말	1
淫肉	음육[淫肉]	1	VBp	//신체부위 :
淫音	음음[淫音]	1	UHr	//음성(음향) :
淫情	음정[淫情]	1	UFl	//감정
淫膣	음질[淫膣]	1	VBp	//신체부위 :
衣ずれ音	옷 스치는 소리	1	UHr	//음성(음향) :
依り代	기댈 곳	1	VPl	//장소 :
意念	의념	1
疑念	의념[疑念]	1
衣装一式	의상 한 벌	1	VCp	//의복
衣擦れ	옷스침	1
耳ざわり	귀에 거슬림	1
二の次	둘째	1
二口	두입	1
伊達	겉멋	1
伊達姿	겉멋부린 모습	1
二刀流	이도류	1	UTt	//기술
二歩	두 걸음	1
餌付け	길들임	1	//餌付けする (えづけ)
耳鼻科	이비인후과	1	VPl	//장소 :
二三口	두세입	1
異常性癖	이상성벽	1
二十四時間	24시간	1
耳奥	귓속	1	VPl	//장소 :
耳障り	귀에 거슬림	1	//耳ざわりな声
耳障りな音	거슬리는 소리	1	UHr	//음성(음향) :
異存	이의	1
耳擦り	귓속말	1	UHr	//음성(음향) :
異臭	이취[異臭]	1	UYm	//냄새(후각)
以下略	이하 생략	1
耳穴	귓구멍	1
二穴	두 구멍	1
人間業	인간의 재주	1
引金	방아쇠	1
人馬一体	인마일체	1
人払い	주위 사람을 없게 함	1
人域超越	인역초월	1
仁王立ち	고압적인 자세	1
引込み思案	숫기가 없음	1
忍従	인종[忍從]	1
一つや二つ	하나나 둘	1
日に焼けた顔	햇볕에 그을린 얼굴	1	VBp	//신체 : 農夫らしく日に焼けた顔と逞しい体を
日光	일광	1
日光除け	햇볕차단	1	//日光除けにと知由が用意してくれた日傘も、
一球一殺	일구일살[一球一殺]	1
一筋縄	보통 수단	1	UMn	//수단(방법,제도)
一気飲み	단숨에 마시기	1
一覧表示	일람표시	1
一縷	한 가닥	1
一粒万倍	일립만배[一粒万倍]	1
一糸	한가닥의 실	1
日暮れ時	해질 때	1	UMe	//시간 :
日暮れ前	해지기 전	1	UMe	//시간 :
逸物	일물[逸物]	1
一瞥	일별[一瞥]	1
一歩二歩	한 걸음 두 걸음	1
一本背負い	한판 업어치기	1	UTt	//기술
一夫一妻	일부일처	1
日射	햇살	1
日射し	햇살	1
一仕事	한가지 일	1
一閃	일섬[一閃]	1
一世一代	일생일대	1
日数	일수	1
一矢一殺	일시일살	1
一雨	한바탕 비	1	//もう一雨来そうな予感がする。
一揉み	한번 주무름	1
一条の光	한 줄기의 빛	1
一条の光明	한 가닥의 광명	1
一周り	한 바퀴	1
一周り年上	12살 연상	1
一周り年下	12살 연하	1
一芝居	연극	1
一陣	일진[一陣]	1
一振り	한번 휘두름	1
一太刀	일태도	1	VTw	//무기 :
一匹二匹	한마리 두마리	1
一喜一憂	일희일비	1
入水	입수	1
子宮口	자궁입구	1	VPl	//장소 :
柘榴	석류	1	QAM	//과일명
髭面	수염투성이 얼굴	1	VBp	//신체부위 :
雌伏	자복[雌伏]	1
自分探し	자기자신 찾기	1
子守唄	자장가	1	USo	//노래
姉心	언니의 마음	1
雌欲	암컷 욕구	1	UFl	//감정
自意識過剰	자의식과잉	1
自主練	자율연습	1
自主練習	자율연습	1
雌化	암컷화	1
腸腔	장강[腸腔]	1
腸管	장관[腸管]	1
将棋盤	장기판	1	VFn	//가구
長手袋	긴 장갑	1	VCp	//의복
掌中	손바닥 안	1	VPl	//장소 :
長銃	장총	1	VTw	//무기 :
張形	딜도	1	VPe	//도구
裁ちばさみ	재단 가위	1	VPe	//도구
再構成	재구성	1
佇まい	풍취	1
猪口	술잔	1
低頭	머리를 숙임	1
咀嚼	저작[咀嚼]	1
吊り革	손잡이	1	VPe	//도구
赤豆	붉은콩	1
覿面	직방	1
赤線	붉은 선	1
赤玉	적옥[赤玉]	1	VJw	//보석
前屈姿勢	앞으로 굽힌 자세	1
全寮制	전원 기숙사제	1
全体重	전체중	1
前非	지난 잘못	1
田舎道	시골길	1	VPl	//장소 :
全身鎧	전신갑	1	VCp	//의복
戦渦	전와[戰渦]	1
戦衣装	전투복	1	VCp	//의복
前人未到	전인미답	1
前程	전정[前程]	1
前蹴り	앞차기	1	UTt	//기술
折り紙付き	확실히 보증함	1
絶句	절구[絶句]	1
切先	칼끝	1
店屋	가게	1	VPl	//장소 :
町工場	동네공장	1	VPl	//장소 :
静観	정관[靜觀]	1
正夢	정몽[正夢]	1
町並み	거리풍경	1
町歩き	마을 산책	1	//町歩きは楽しかったけど、今までの疲れもたっぷりと溜まってる。
釘付け	못박음	1
正史	정사	1
正三角	정삼각	1
正常位	정상위	1	UTt	//기술
精液	정액	1	VLu	//분비물
梃子	지렛대	1
斉射	일제사격	1	UTt	//기술
弟的存在	남동생적 존재	1
醍醐味	참된 맛	1	UYa	//맛(미각) :
誂え向き	안성맞춤	1
早とちり	지레짐작	1
釣り込み技	끌어들이는 기술	1	UTt	//기술
照れ隠し	수줍음 감추기	1
鳥居	신사 기둥문	1
朝練	아침연습	1
嘲弄	조롱	1
朝勃ち	아침발기	1
早弁	도시락 까먹기	1
調伏	조복[調伏]	1
彫像	조상[彫像]	1
爪先	발끝	1
鯛焼き	붕어빵	1	VFd	//음식(음료) :
早数日	벌써 며칠	1
早耳	빠른 귀[早耳]	1
朝日	아침해	1
朝一番	아침 일찍	1	UMe	//시간 :
早朝	이른 아침	1	UMe	//시간 :
朝昼	아침 점심	1
足の筋	다리 근육	1	VBp	//신체부위
足枷	족쇄	1	VAc	//장신구
足甲	발등	1	VBp	//신체부위 :
足留め	발이 묶임[足留め]	1
足留め策	발을 붙잡을 방책	1
足先	발끝	1
足止め	발이 묶임[足止め]	1
足止め策	발을 붙잡을 방책	1
縦筋	세로선[縱筋]	1
縦長	종장[縱長]	1
縦割り	세로베기	1	UTt	//기술
左隣	왼쪽 옆	1	VPl	//장소 :
左目	왼쪽 눈	1	VBp	//신체부위 :
左膝	왼쪽 무릎	1	VBp	//신체부위 :
座位	좌위	1	UTt	//기술
左前	우전[左前]	1
左向け左	좌향좌	1
左頬	왼쪽 뺨	1	VBp	//신체부위 :
左胸	왼쪽 가슴	1	VBp	//신체부위 :
呪具	주술도구	1	VPe	//도구
注挿	삽입질	1
厨二病	중2병	1
呪詛	저주	1
昼前	오전	1	UMe	//시간 :
注ー目	주-목	1
住処	거처	1	VPl	//장소 :
肘鉄	팔꿈치치기	1	UTt	//기술
竹光	죽도	1	VTw	//무기 :
逡巡	망설임	1	UFl	//감정
噂話	소문	1
中イキ	질내사정	1
重光線	중광선	1
中途半端	애매함	1
重武装	중무장	1
重巡洋艦	중순양함	1	VTp	//교통수단
中央区	중앙구역	1	VPl	//장소 :
中原	중원	1	VPl	//장소 :
重装備	중장비	1
即戦力	즉시전력	1
蒸しタオル	찐 수건	1
指づかい	손가락 사용	1	UTt	//기술
指の腹	손가락 안쪽	1
舐めた視線	깔보는 시선	1	//女共はチラッとコッチを見て舐めた視線を向ける。
舐めた態度	깔보는 태도	1	//浮気して舐めた態度を取る嫁に復讐してやった。
指姦	지간[指姦]	1
至近距離	지근거리	1	UXd	//거리
知己	지기	1
指南書	지도서	1	VBk	//책
指弄	손장난	1
指弄り	손장난	1
枝毛	갈라진 머리카락	1	VBp	//신체부위 :
至宝	지보[至寶]	1
指腹	손가락 안쪽	1
紙束	종이다발	1
紙玉	종이구슬	1
地獄耳	지옥귀[地獄耳]	1
地獄絵	지옥도	1	VSp	//그림
地獄絵図	지옥도	1	VSp	//그림
只中	한복판	1	VPl	//장소 :
知恵熱	열병	1	UTi	//질병 :
職務放棄	직무태만	1
直伝	직전[直傳]	1
姫蕾	희뇌[姬℡뇌]	1	//후처리에서 _뇌_ -> 蕾
真名	본명	1
真相究明	진상규명	1
姫肉蕾	희육뇌[姬肉℡뇌]	1	//후처리에서 _뇌_ -> 蕾
姫肉門	희육문[姬肉門]	1	VBp	//신체부위 :
珍種	진종[珍種]	1
姫唇	희순[姬唇]	1	VBp	//신체부위 :
塵取	쓰레받이	1	VPe	//도구
鎮魂	진혼	1
姫花	희화[姬花]	1
姫花肉	희화육[姬花肉]	1	VBp	//신체부위 :
膣孔	질구멍[膣孔]	1	VBp	//신체부위 :
膣口	질구[膣口]	1
膣内出し	질내사정	1
膣道	질도[膣道]	1
膣洞	질동[膣洞]	1
膣襞	질벽	1
膣奥	질 안쪽	1	UDr	//방향
膣肉	질육[膣肉]	1	VBp	//신체부위 :
膣中射精	질내사정	1
膣穴	질 구멍	1	VBp	//신체부위 :
膣壷	질단지[膣壺]	1	VBp	//신체부위 :
澄之江	스미노에	1	QCTVBl	//지명,장소
着物	기모노	1	VCp	//의복
擦れ枯し	닳고 닳음	1	UYi	//내적 형용 :
擦れ枯らし	닳고 닳음	1	UYi	//내적 형용 :
察知	짐작	1
斬機刀	참기도	1	VTw	//무기 :
菖蒲	창포[菖蒲]	1	VPt	//식물이름. 붓꽃. 사람 이름이기도 하다 (아야메)
蒼海	창해[蒼海]	1	VPl	//장소 :
磔状態	묶인 상태	1
隻眼	애꾸눈	1
喘ぎ声	허덕이는 소리	1	UHr	//음성(음향) :
天変地異	천재지변	1
泉源	천원[泉源]	1
千人隊	천인대	1	VGt	//집합(군집)
千摺り	용두질	1
天誅	천주[天誅]	1
天津	텐진	1	QCTVPl	//장소, 지명 :
天下御免	천하공인	1
鉄の棒	철봉	1
鉄格子	쇠창살	1
鉄杭	쇠말뚝	1
添乗	수행안내	1
睫毛	속눈썹	1	VBp	//신체부위 :
清涼感	청량감	1
青痣	푸른 멍	1
清濁	청탁[淸濁]	1
諦観	체관[諦觀]	1
躰全部	신체 전부	1
躰全体	신체 전체	1
躰中	신체 안	1	VPl	//장소 :
草の蔓	풀의 덩굴	1	VPt	//식물 :
草むしり	풀뽑기	1
初見	초견[初見]	1
初対面	첫대면	1
草毟り	풀뽑기	1
初物	초물[初物]	1
初任務	첫 임무	1
初出勤	첫 출근	1
触りっこ	만지기	1
触り心地	만지는 느낌	1	UYt	//촉감
寸での所	위기의 순간	1	UMe	//시간 :
総司令	총사령	1
惣菜	나물	1	VFd	//음식
総菜	나물	1	VFd	//음식
最高の出来	최고의 성과	1
最高位	최고위	1	UXg	//위치고저
最上位	최상위	1	UXg	//위치고저
最弱	최약	1	UYs	//강도
最下位	최하위	1	UXg	//위치고저
追いかけっこ	술래잡기	1
抽斗	서랍	1	VFn	//가구
推力	추력	1
抽送	삽입질	1
抽迭	삽입질	1
軸足	디딤발	1	VBp	//신체부위 :
春頃	봄경	1	UMe	//시간 :
出かけ際	나갈 때	1	UMe	//시간 :
出だし	첫시작	1
出家	출가	1
出掛け中	외출중	1	//公爵様はお出かけ中でございます
出立	출발	1
出世の蔓	출세의 연줄	1
出自	출신	1
出出し	첫시작	1
臭跡	냄새 흔적	1
側溝	배수로	1
側道	샛길	1
側位	측위	1	UTt	//기술
置き場所	보관장소	1	VPl	//장소 :
歯噛み	이를 갊	1
恥垢	치구[恥垢]	1
恥裂	치열[恥裂]	1
歯磨	양치질	1
恥蜜	치밀[恥蜜]	1	VLu	//분비물
恥声	치성[恥聲]	1
歯軋り	이를 갊	1
恥肉	치육[恥肉]	1	VBp	//신체부위 :
熾火	숯불	1
親離れ	자립	1
親子丼	오야코동	1	VFd	//음식(음료) :
親切心	친절한 마음	1
七星石	칠성석	1
七転八倒	칠전팔도[七轉八倒]	1
寝物語	잠자리에서의 이야기	1
針先	바늘 끝	1
浸潤	침윤[浸潤]	1
浸入	칩입	1
寝姿	자는 모습	1
快美	쾌미[快美]	1
他所	다른 장소	1	VPl	//장소 :
卓袱台	밥상	1	VFn	//가구
誕生花	생일꽃	1
誕生会	생일파티	1
脱衣所	탈의실	1	VPl	//장소 :
脱兎	도망가는 토끼	1
蕩け視線	녹은 시선	1
湯屋	공중목욕탕	1	VPl	//장소 :
湯治	온천요양	1
太幹	태간[太幹]	1
駄目元	밑져야 본전	1
駄洒落	어설픈 익살	1
台車	손수레	1	VTp	//교통수단
駄駄	응석	1
太腿	허벅지	1	VBp	//신체부위 :
土産物	토산물	1
土埃	흙먼지	1
土足	흙발	1
退屈凌ぎ	심심풀이	1
破れかぶれ	자포자기	1
破瓜	파과[破瓜]	1
波濤	파도	1
判子	도장	1
八つあたり	화풀이	1
八つ当たり	엉뚱한 화풀이	1
唄声	노랫소리	1	UHr	//음성(음향) :
膨れっ面	부푼 얼굴	1	VBp	//신체부위 :
片脚	한쪽 다리	1	VBp	//신체부위 :
片時	잠시	1
鞭打ち	채찍질	1
平手打ち	손바닥 치기	1	UTt	//기술
平安	평안	1
閉じ気味	닫힌 기색	1
捕り物	범인체포	1
咆哮	포효	1	UHr	//음성(음향) :
彼女らしさ	그녀다움	1
披露	피로[披露]	1
疲労困憊	기진맥진	1
披露宴	피로연	1
被服室	의상실	1	VPl	//장소 :
筆下ろし	동정깨기	1
下ネタ	저질 이야기	1
夏バテ	더위먹음	1	UTi	//질병 :
何鍋	무슨 냄비	1
何鍋目	몇 냄비째	1
何巻	몇권	1
何段	몇단	1
夏木立	여름숲	1	VPl	//장소 :
何味	무슨 맛	1
何杯	몇잔	1
下腹の奥	아랫배 속	1	VPl	//장소 :
何食わない顔	새침한 얼굴	1	VBp	//신체부위 :
何食わない態度	새침한 태도	1
下乳	아랫가슴	1	VBp	//신체부위 :
何人当たり	몇 인당	1
何座	무슨 자리	1
下穿き	속옷	1	VCp	//의복
下駄箱	신발장	1	VFn	//가구
夏休み	여름휴가	1
学園前	학원 앞	1	VPl	//장소 :
学園中	학원 중	1	VPl	//장소 :
汗の粒	땀방울	1	VLu	//분비물
汗粒	땀방울	1	VLu	//분비물
閑話休題	한화휴제	1
割り箸	젓가락	1	VPe	//도구
合わせ目	이음새	1
合点	납득	1
肛姦	항간[肛姦]	1
肛腔	항강[肛腔]	1	VBp	//신체부위 :
肛虐	항학[肛虐]	1
肛穴	항문	1	VBp	//신체부위 :
海原	해원	1	VPl	//장소 :
解呪	해주[解呪]	1
海風	해풍	1
行かれた話	얼빠진 이야기	1
行きっぷり	가는 모습	1
行き際	갈 때	1	UMe	//시간 :
行末	행말[行末]	1
香草	향초	1
嘘辨明	거짓 변명	1
嘘寝	거짓잠	1
革鎧	가죽갑옷	1	VCp	//의복
革着	가죽옷	1	VCp	//의복
血だまり	피 웅덩이	1
穴口	구멍입구	1	VPl	//장소 :
穴奥	구멍 속	1	VPl	//장소 :
頬ずり	뺨 비비기	1
頬擦り	뺨 비비기	1
頬の肉	볼살	1	VBp	//신체부위 :
挟射	슴가섹스[狹射]	1
頬肉	볼살	1	VBp	//신체부위 :
荊州	형주	1	QCTVPl	//장소, 지명 :
好感触	좋은 느낌	1
呼鈴	초인종	1
湖面	호수면	1
湖畔	호숫가	1	VPl	//장소 :
豪遊	호유[豪遊]	1
狐耳	여우귀	1	VBp	//신체부위 :
好印象	좋은 인상	1
胡座	책상다리	1
もぬけの空	빈 껍질	1
魂胆	꿍꿍이	1
渾然一体	혼연일체	1
惚気	배우자 자랑	1
紅蕾	붉은 꽃봉우리	1
哄笑	홍소[哄笑]	1
紅花	붉은 꽃	1	VPt	//식물 :
化けっぷり	변한 모습	1
花の蕾	꽃봉오리	1	VPt	//식물
和み系	온화계	1	UYi	//내적 형용 :
和歌	와카[和歌]	1	USo	//노래
火蓋	화약뚜껑	1
花道	화도	1
火伏せ	화제 방지	1
和傘	일본우산	1	VPe	//도구
靴箱	신발상자	1	VFn	//가구
花珠	꽃 진주	1
花唇	화순[花唇]	1
花香	꽃향기	1	UYm	//냄새(후각)
確執	갈등	1
丸わかり	뻔히 보임	1	//自らの利益を守ろうと必死なのが丸わかりだ
幻想郷	환상향	1	VPl	//장소 :
黄金郷	황금향	1	VPl	//장소 :
荒縄	밧줄	1
悔し気	분한 기분	1
回し蹴り	돌려차기	1	UTt	//기술
回り合せ	운명	1
回り合わせ	운명	1
回廊	회랑	1	VPl	//장소 :
懐中電灯	손전등	1	VPe	//도구
会話らしい会話	회화다운 회화	1
横倒し	옆으로 쓰러짐	1
横穴	횡혈[橫穴]	1
後ろ髪	뒷머리	1
朽木	썩은 나무	1	VPt	//식물 :
後背位	후배위	1	UTt	//기술
後背座位	배후좌위	1	UTt	//기술
喉奥	목 안	1	VPl	//장소 :
厚意	후의[厚意]	1
後漢朝	후한조	1
喧噪	소란함	1
虫取り	벌레잡이	1
虫唾	신물	1
胸鎧	흉갑	1	VCp	//의복
胸肌	가슴살갗	1	VBp	//신체부위 :
胸当て	흉갑	1	VCp	//의복
胸奥	가슴 속	1	VPl	//장소 :
胸元	앞가슴	1
胸板	가슴판	1
黒翼	검은 날개	1
黒板	칠판	1
黒板消し	칠판지우개	1	VPe	//도구
黒革	검은 가죽	1
屹立	흘립[屹立]	1
欠き氷	빙수	1
希望の種	희망의 씨앗	1
折り畳み	접이식 우산	1
蛇の目	뱀의 눈	1	VBp	//신체부위 :
仏頂面	시무룩한 얼굴	1	VBp	//신체부위 :
偽善者面	위선자 얼굴	1	VBp	//신체부위 :
電柱	전봇대	1
念押し	거듭한 다짐	1
ミスタイプ	오타	1
オーバードース	과다복용	1
愛想尽かし	정떨어짐	1
シモジモ	하층민	1	VGt	//집합(군집)
ポンコツ	폐품	1
スリープ	슬립	1	//카타 발음을 위해 추가 : サイレントスリープ
電脳	전뇌	1	//ほらほら、あの電脳少女ミクちゃんだよ
眠気覚まし	졸음쫒기	1	//眠気覚ましのドリンクがバリバリ効いていた。
へどろ	진흙탕	1	//丁寧な言葉でも中身はドロッドロのヘドロね
何泊	몇 박	1	//ホテル代くらいは出せるけど……何泊もは正直きつい。
イージー	이지	1	//카타 발음을 위해 추가
七星祭	칠성제	1	UCl	//종교행위(수단)
山遊び	산놀이	1
ハーヴェスト	하베스트	1
シンギュラリティ	Singularity	1
海棲生物館	해저생물관	1	VPl	//장소 :
騎体性能	기체성능	1
心甲一致	심갑일치	1
探査機能	탐사기능	1
天下布武	천하포무	1
合戦礼法	합전예법	1
無垢	무구	1
塩田	염전	1	VPl	//장소 :
生類哀れみの令	살생금지령	1	//♞生類憐れみの令
役職	직위	1
禄高	녹봉	1
朝餉	아침 식사	1	VFd	//음식(음료) :
夕餉	저녁 식사	1	VFd	//음식(음료) :
笹屋	오두막집	1	VPl	//장소 :
影踏み	그림자 밟기	1
江戸詰め	에도에서 근무	1
桜花	벚꽃	1	QAL	//꽃이름(풀이름)
感応能力	감응능력	1
楽勝	낙승	1
ヤキモチ	질투	1	UFl	//감정
肌身	몸	1	VBp	//신체부위 :
縁起	조짐[緣起]	1
すぺしゃる	스페셜	1
ヒ・ミ・ツ	비·밀	1
ニホンゴ	일본어	1
マボロシ	환상	1
ヤキイモ	군고구마	1	VFd	//음식(음료) :
夏の始まり	여름의 시작	1
アースプライヤー	어스 플라이어	1	VPe	//도구
一押し	한번 밀기[一押し]	1	//最後の一押しが無いとあたし激サムじゃん！
戦いの火蓋	전투의 포문	1
夜の物語	밤의 이야기	1	//甘く切ない夜の物語が幕を開けるのだった
四万年	4만년	1
アクシツ	악질	1
あくしゅ	악수	1
あいすくりーむ	아이스크림	1	VFd	//음식(음료) :
アイスバニッシャー	아이스 배니셔	1
魔法円	마법진	1	//つまりその魔法円は間違えている…？
希臘語	희랍어	1
神名	신명[神名]	1
グリッド	그리드	1
一日千秋	일일천추[一日千秋]	1	//一日千秋とお待ちしておりますわ
オーシャンズ	오션스	1
先輩ん家	선배네 집	1	VPl	//장소 :
関の山	고작	1	//からかわれるくらいが関の山です
ツッコミどころ	츳코미할 곳	1	VPl	//장소 : 意外と個性があったりツッコミどころがあったりして面白いものなんですよ
ジャンクション	Junction	1
猫口	고양이입	1	VBp	//신체부위 :
開いたドア	열린 문	1
不精	부정[不精]	1
アダファルス	아다파르스	1
アスタロト	아스타로트	1
賽銭箱	새전함[賽錢箱]	1
誉め言葉	칭찬하는 말	1	//誉め言葉だと思っとくよ
あてんしょん	어텐션	1
収束	수속[收束]	1
頭頂	두정[頭頂]	1
顔一つ	얼굴 하나	1
アホヅラ	바보 얼굴	1	VBp	//신체부위 :
あやとり	실뜨기	1
アリオン	아리온	1
アルチェ	아르체	1
アルディヒナ	아르디히나	1
散歩日和	산책하기 좋은 날씨	1	//お散歩日和です
然るべきもの	마땅한 것	1	//然るべきものだろう？
主菜	주채[主菜]	1
副菜	부채[副菜]	1
お世辞	겉치레말	1	//お世辞にも良くなかった
探り合い	떠보기	1	//別段腹の探り合いも必要ありませんか
腹の探り合い	속셈 떠보기	1	//別段腹の探り合いも必要ありませんか
鍔元	날밑 부분	1	//次の刹那、一瞬の間隙に刃を引くと同時にその鍔元を狙って互いの太刀が閃めく。
戸口	호구[戶口]	1
いもきんつば	이모킨츠바	1	VFd	//음식(음료) :
みらくる	미러클	1
薬漬け	약품 과다투여	1
いたわり	위로	1
イジめ	이지메	1
イスベル	이스벨	1	//카타카나 발음을 위한 것
たまの休み	어쩌다 있는 휴일	1
箱型	상자형	1
ストンピング	스톰핑	1
何歩	몇 걸음	1	//何歩譲ってもパイズリだ。
ちっぱい	작은 가슴	1	VBp	//신체부위 :
伸ばした足	뻗은 다리	1	VBp	//신체부위 :
伸ばした手	뻗은 손	1	VBp	//신체부위 :
隙間跡	틈새자국	1
インフェルノ	인페르노	1	VPl	//장소 :
垂れ乳	늘어진 젖	1	VBp	//신체부위 :
残照	저녁노을	1
オホーツク	오호츠크	1	VPl	//장소 :
共同施設	공동시설	1	VPl	//장소 :
助け舟	구조선	1	VTp	//교통수단
たぬきそば	다누키 소바	1	VFd	//음식(음료) :
針のむしろ	가시방석	1
警備砦	경비 요새	1	VPl	//장소 :
アドリブ	애드립	1
ウエットティッシュ	물티슈	1
初経験	첫경험	1
養子縁組	양자결연[養子緣組]	1
ちんこ	고추	1	VBp	//신체부위 :
注目の的	주목의 대상	1
シロツメクサ	토끼풀	1	VPt	//식물 :
白詰草	토끼풀	1	VPt	//식물 :
焼き鮭	연어구이	1	VFd	//음식(음료) :
大判焼き	오방떡	1	VFd	//음식(음료) :
不機嫌	불쾌함	1	UFl	//감정 : どうやら昨日の不機嫌を引きずっているようだ。
ふかしイモ	찐 고구마	1	VFd	//음식(음료) :
ファンファーレ	팡파레	1	UHr	//음성(음향) :
野菜炒め	야채볶음	1	VFd	//음식(음료) : 俺は野菜炒めでも作るか…
その口調	그 어조	1	//その口調が信じられないほど明るくって前向きで。
バタ足	물장구	1
台所事情	주머니 사정	1
ポン酢	퐁즈	1	VFd	//음식(음료) :
七国	칠국	1
フィギュアスケート	피겨 스케이트	1
律儀	율의	1
オオゴト	큰 일	1
キュウリの浅漬け	오이절임	1	VFd	//음식(음료) :
煎餅	전병	1	VFd	//음식(음료) :
ほうじ茶	호지차[ほうじ茶]	1	VFd	//음식(음료) :
しどろもどろ	횡설수설	1
樹の下	나무 아래	1	VPl	//장소 :
めんつゆ	멘쯔유	1	VFd	//음식(음료) :
レジェンダリー	레전더리	1
オウンゴール	자살골	1
見えっ張り	허세부림	1
見栄っ張り	허세부림	1
特盛り	특대	1
大元	근본	1	//大元を考えてみようよ。
二天一流	이천일류[二天一流]	1
アクロバティック	아크로바틱	1
沸点	끓는점	1
融点	녹는점	1
氷点	어는점	1
ラム酒	럼주	1	VFd	//음식(음료) :
時間の無駄	시간 낭비	1
めんたいこ	명란젓	1	VFd	//음식(음료) :
ひげ面	수염 많은 얼굴	1	VBp	//신체부위 :
マドレーヌ	마들렌	1
ランターン	랜턴	1
クィック	퀵	1
スカベンジャー	스캐빈저	1
下衆の勘ぐり	비열한 중상	1
助走	도움닫기	1
マンガリッツァ	만갈리차	1	VFd	//음식(음료) :
木っ端微塵	산산조각	1
羽交い締め	날갯죽지 조르기	1
カツ丼	카츠동	1	VFd	//음식(음료) :
冬虫夏草	동충하초	1	VPt	//식물 :
器用貧乏	다재무능[器用貧乏]	1
お花畑	꽃밭	1	VPl	//장소 :
オールオッケー	올 오케이	1
辻斬り	츠지기리[つじ斬り]	1
つじ切り	츠지기리[つじ切り]	1
栗の花	밤꽃	1	QAL	//꽃이름(풀이름)
エイプリルフール	만우절	1
バトミントン	배드민턴	1
目のつけどころ	착안점	1
コルシカ	코르시카	1
足の指	발가락	1	VBp	//신체부위 :
諸刃の剣	양날의 검	1
ノンアルコール	논알코올	1
キャプチャー	캡처	1
振袖	후리소데[振袖	1	VCp	//의복
ニップレス	니플리스	1
ブレスレット	브레이슬릿	1
トパーズ	토파즈	1
クラシカル	클래시컬	1
フェニックス	피닉스	1
フェードイン	페이드 인	1
フェードアウト	페이드 아웃	1
シュレディンガー	슈뢰딩거	1
リヴァイアサン	리바이어던	1
カラーリング	컬러링	1
クオリア	퀄리아	1
ミョルニル	묠니르	1
パッケージング	패키징	1
バームクーヘン	바움쿠헨	1
ジュネーヴ	제네바	1	QCT	//도시(지명)명
学び舎	배움터	1	1	VPl	//장소 :
玉に瑕	옥의 티	1
バニッシュ	배니시	1
プッシング	푸싱	1
アイアンメイデン	아이언 메이든	1
防具	방어구	1
デッドオアアライブ	데드 오어 얼라이브	1
ガラパゴス	갈라파고스	1	QCT	//도시(지명)명
揺り椅子	흔들의자	1	VFn	//가구
ホールデム	홀덤	1
三すくみ	삼자견제	1
ヴァルハラ	발할라	1
昔々	옛날 옛날	1
棒立ち	우뚝선 자세	1
マグロ漁船	참치 어선	1
巨乳もの	거유물	1
目移り	눈움직임	1
半脱ぎ	반나체	1
分れ道	갈림길	1
ゴロ合わせ	연상 암기법	1
湯船のヘリ	욕조 가장자리	1	VPl	//장소 :
一筋の汁	한줄기 즙	1	VLq	//액체
両思い	서로 사모함	1	//二人が両想いになる。じゃあ私たち、両思いで……ん……つ、付き合って……くれるの？
両想い	서로 사모함	1	//二人が両想いになる。じゃあ私たち、両思いで……ん……つ、付き合って……くれるの？
お伽噺	옛날 이야기	1
ユーウツ	우울	1	UFl	//감정
お椀	밥공기	1
淫夢	음몽[淫夢]	1
大連呼	대연호	1
付箋	포스트잇	1
棒読み	단조롭게 읽기	1	//「……姉ちゃん、棒読みになってるよ」
依怙贔屓	한쪽만 편듦	1
エコヒイキ	한쪽만 편듦	1
アダ名	별명	1
半剥け状態	반 벗겨진 상태	1
何週間振り	몇 주간만	1
来襲	내습	1
差し金	곱자[差し金]	1
八つ裂き	갈가리 찢음	1
東京	도쿄	1
つぶて	돌멩이	1
ましろうどん	마시로 우동	1	VFd	//음식(음료) :
虫のしらせ	불길한 예감[蟲のしらせ]	1
虫の知らせ	불길한 예감[蟲の知らせ]	1
タロットカード	타로 카드	1
少し回った時間	조금 지난 시간	1	UMe	//시간 :
枯芝	마른 잔디	1	VPt	//식물 :
戯れ言	농담	1
コミニュケーション	커뮤니케이션	1
赤面症	안면홍조증	1	UTi	//질병 :
晩ごはん	저녁밥	1	VFd	//음식(음료) :
ゆびきり	약속	1
繁み	수풀	1
リゾット	리조토	1	VPl	//장소 :
板挟み	진퇴양난	1
トコシエ	영원	1
何時ぶり	얼마만	1	//他人と肩を並べるなんて何時ぶりか
手負い	상처입음	1	//手負いである白い少女にとって最も望ましい日時
ブレス	브레스	1
同い歳	같은 나이	1
少子化	저출산화	1
驚き所	놀라운 곳	1
焼き餅	구운 떡	1	VFd	//음식(음료) :
一頭	한 마리	1	//ただ一頭か。
トゥインクル	트윙클	1
虎の尾	호랑이 꼬리	1
アイシクル	아이시클	1
チェイン	체인	1
夜の森	밤의 숲	1	VPl	//장소 :
力任せ	전력	1	//力任せで壊すのは現実的ではありません。
小影	작은 그림자	1
唸り声	신음소리	1	UHr	//음성(음향) :
足場	발판	1
太刀筋	칼솜씨	1
カプセル	캡슐	1
くるせいだーす	크루세이더스	1
エスクワイア	에스콰이어	1
いろとりどり	각양각색	1
小粋	멋짐	1
エビフライ	새우튀김	1	VFd	//음식(음료) :
ほうけた顔	얼빠진 얼굴	1	VFd	//음식(음료) :
ほうけた表情	얼빠진 표정	1
辞令	사령[辭令]	1	//誰だ地上担当の辞令出したの。
全部の部屋	모든 방	1	VPl	//장소 :
ねこじゃらし	강아지풀	1	VPt	//식물 : 箱の脇にねこじゃらしがあるじゃないか
しゃべりかた	말투	1
おせんたくもの	세탁물	1
大食事会	대식사회	1
大食堂	대식당	1
リーダーシップ	리더십	1
好都合	안성맞춤	1
オーガズム	오르가즘	1
サポーター	서포터	1
セキュリティ	시큐리티	1
固定概念	고정관념	1
食器洗い機	식기세척기	1
ネタバレ	네타바레	1
ねたばれ	네타바레	1
脳味噌	뇌수	1
脳ミソ	뇌수	1
ぶっちゃけた話	까놓고 하는 이야기	1
立ち場	입장	1
どん引き	썰렁	1
ドン引き	썰렁	1
正義の味方気取り	정의의 편 기분내기	1
正義の味方	정의의 편	1
ひみつ	비밀	1	//ごくごくのひみつ
ガーリック	갈릭	1	VFd	//음식(음료) :
燃えた目	불탄 눈	1	VBp	//신체부위 :
涙交じり	눈물 섞임	1
こどもだまし	어린애 속임수	1
こども騙し	어린애 속임수	1
子供だまし	어린애 속임수	1
子供騙し	어린애 속임수	1
身一つ	몸 하나	1
良がり声	교성	1	UHr	//음성(음향) :
善がり声	교성	1	UHr	//음성(음향) :
よがり声	교성	1	UHr	//음성(음향) :
使いどころ	사용하는 곳	1	VPl	//장소 : 使いどころ間違ってるよ。
胸くそ	기분	1
むなくそ	기분	1
むねくそ	기분	1
機織	베짜기	1
これいじょう	이 이상	1
それいじょう	그 이상	1
あれいじょう	저 이상	1
なにごと	무슨 일	1
ひと息	한숨	1
おつき合い	교제	1
しめんそか	사면초가	1	//四面楚歌 (しめんそか)
しらみつぶし	철저히 뒤짐	1	//虱潰し (しらみつぶし)
じっさい	실제	1
せんずり	용두질	1
センズリ	용두질	1
たからもの	보물	1
たてすじ	세로선[縱筋]	1
タテスジ	세로선[縱筋]	1
だいいんしん	대음순	1	VBp	//신체부위 :
おだいどころ	부엌	1
脱衣かご	탈의 바구니	1
ちぎりき	몽둥이	1
熟れ鮨	나레즈시	1	VFd	//음식(음료) :
なれ鮨	나레즈시	1	VFd	//음식(음료) :
一騎	일기[一騎]	1
一騎打ち	일대일 대결	1
一騎打	일대일 대결	1
ここらへん	이 근처	1	VPl	//(장소)
道ばた	도로변	1	VPl	//(장소)
したっぱ	아랫쪽	1	UDr	//방향
ほえ面	울상	1
耳っ擦り	귓속말	1
耳っこすり	귓속말	1
太刀打	맞겨룸	1
せくはら	성희롱	1
じょーだん	농담	1
かんけー	관계	1	//かんけーねーよ。
お手伝い	거들기	1
おてつだい	거들기	1
かんげき	감격	1	UFl	//감정 : 感激
お互いさま	피차일반	1
へっちゃら	만사태평	1
しくはっく	온갖 고통	1
しんじつ	진실	1
気やすめ	위안	1
カレー味	카레맛	1	UYa	//맛(미각) :
チーズ味	치즈맛	1	UYa	//맛(미각) :
虫かご	곤충상자	1
心頭滅却	심두멸각	1
てるてる坊主	테루테루보즈	1
照る照る坊主	테루테루보즈	1
てるてるぼうず	테루테루보즈	1
射手座	궁수자리	1
コントローラー	컨트롤러	1
ネギトロ丼	네기토로동	1	VFd	//음식(음료) :
長柄	긴 자루	1	//漆黒の阿吽の腕に抱かれた長柄が宙を旋回する。
にんしき	인식	1
穢土	예토[穢土]	1
大門	대문	1
リスペクト	리스펙트	1
長毛	장모[長毛]	1
スリーパー	슬리퍼	1
水飛沫	물보라	1
空容器	빈 용기	1
ぱちんこ	빠칭코	1
早歩き	빠른 걸음	1
踵落とし	내려차기	1
精神衛生	정신건강	1
オッドアイ	오드아이	1
筋肉弛緩剤	근육이완제	1
シュレーディンガー	슈뢰딩거	1
磨ぐ音	가는 소리	1	//包丁を磨ぐ音まで聞こえる。
ヒトトキ	한 때	1	//あまーいヒトトキを過ごして帰るから
エヴォリューション	에볼루션	1
ヒロイック	히어로익	1
ユニット	유닛	1
横スクロール	횡스크롤	1
無頓着	무관심	1	//恋愛事に関してはウブを通り越して無頓着。
ツイッター	트위터	1
アナザー	어나더	1
持久走	오래 달리기	1
得意種目	자신있는 종목	1
道路脇	도로 옆	1	//道路脇に停めてあった車から降りてきた。
ベーグル	베이글	1
突貫	강행[突貫]	1	//突貫で悪いけど、みんな頑張ってくれよ！
探検ごっこ	탐험놀이	1
学祭	학원제	1
ボストン茶会事件	보스턴 차 사건	1
笑い事	웃을 일	1	//笑い事じゃねーよ。
生姜焼き	돼지고기 생강구이	1	VFd	//음식(음료) :
ナンバーズ	넘버스	1
しのび足	살금살금 걸음	1
忍び足	살금살금 걸음	1
ワンニャン	완냥	1	//개, 고양이의 울음소리라 함
ひと筋	외곬	1	//有坂さん、私たちずっとスピーダーひと筋でいましょう
ひしゃく	국자	1
とらえどころ	붙잡을 곳	1	//とらえどころのない空だった。
平和主義	평화주의	1
仮留め	임시 고정	1	//まずはピンで仮留めするところからだよ
留め鋲	압정	1
門留め	출입금지	1
ピン留め	머리핀	1
仰天	앙천[仰天]	1	//そして、待ち構えていた光景に仰天する。
敷布団	이불	1
兎小屋	토끼장	1	VPl	//장소 :
煮込み料理	삶은 요리	1	VFd	//음식(음료) :
天狗舞	텐구마이[天狗舞]	1
昼風呂	낮목욕	1
洗濯バサミ	빨래집게	1
板ばさみ	진퇴양난	1
ひなたぼっこ	햇볕쬐기	1
猫缶	고양이 통조림	1	VFd	//음식(음료) :
二言目	입버릇	1
爆睡	깊은 잠[爆睡]	1
扇状	부채꼴[扇狀]	1
暇人よばわり	한가한 사람 취급	1	//どいつもこいつも二言目には人を暇呼ばわりしやがって。
暇呼ばわり	한가한 사람 취급	1	//どいつもこいつも二言目には人を暇呼ばわりしやがって。
神木	신목[神木]	1	VPt	//식물 :
何語	무슨 언어	1
下世話	속된 말	1	//(x)下世話な方向の疑惑だろう……
死屍累々	시산혈해[死屍累累]	1
良薬	좋은 약	1
股割り	가랑이 찟기	1
おうどん	우동	1	VFd	//음식(음료) :
抑え目	자제하는 편	1	//練習も抑え目に行こうかと。
屑籠	휴지통	1
大外刈り	밭다리 후리기	1
朝昼晩	아침 점심 저녁	1	//朝昼晩の食事じゃねーんだっつーの。
重低音	중저음	1
蒸し料理	찜요리	1	VFd	//음식(음료) :
はらごしらえ	배를 채워둠	1
トンコツ	돈코츠	1	VFd	//음식(음료) :
恐悦至極	공열지극[恐悅至極]	1
足運び	발걸음	1	//道場と同じ足運びをしていたら
だらけ癖	게으른 버릇	1
取り替えっこ	바꾸기	1
浅漬け	야채절임	1	VFd	//음식(음료) :
時差ボケ	시차적응	1
逆切れ	적반하장	1
別口	다른 종류	1	//別口ってことだ。
古手ぬぐい	낡은 수건	1
飛び道具	원거리 무기	1	VTw	//무기 :
村中	마을 안	1	VPl	//장소 :
炊きたて	갓 만든 밥	1	VFd	//음식(음료) :
純粋無垢	순진무구	1
後ろ倒し	뒤로 미룸	1
余白	여백	1
訓練所	훈련소	1	VPl	//장소 :
轢殺	역살[轢殺]	1
ひっさしぶり	오랜만	1
飛び方	나는 방법	1	UTt	//기술 : わたしに飛び方を
沈んだ顔	침울한 얼굴	1	VBp	//신체부위 :
半立ち	반쯤 서기[半立ち]	1
ディープキス	딥키스	1
被害者面	피해자 얼굴	1	VBp	//신체부위 :
御椀	그릇	1
立ち聞き	엿듣기	1
世界樹	세계수	1	VPt	//식물 :
短き命	짧은 생명	1
仇討ち	복수	1
ばんそうこ	반창고	1
卵かけご飯	계란덮밥	1	VFd	//음식(음료) :
大音量	대음량	1
安アパート	임대 아파트	1	VPl	//장소 :
戦闘訓練	전투훈련	1
金目的	돈 목적	1	//金目的でも、テロでもない。
背すじ	등줄기	1	VBp	//신체부위 :
ママゴト	소꿉장난	1
掃き溜め	쓰레기터	1	VPl	//장소 :
鮨詰め	꽉 들어참	1
痛車	이타샤[痛車]	1	VTp	//교통수단
顔文字	이모티콘	1
リニアモーターカー	자기부상열차	1	VTp	//교통수단
抱き枕	껴안는 베게[抱き枕]	1
前段階	전단계	1
口角泡	게거품	1
万々歳	만만세	1
金床	모루	1	VPe	//도구
佳き日	경사스런 날	1
毒入りリンゴ	독이든 사과	1	QAM	//과일명
ネツアイ	열애	1	UFl	//감정
逸材	일재[逸材]	1
居住まい	앉은 자세	1
わめき声	아우성	1	UHr	//음성(음향) :
サツガイ	살해	1
シガレット	시거렛	1
来航	내항	1
ユカイツーカイ	유쾌통쾌	1
責任逃れ	책임회피	1
オマツリ	축제	1
足コキ	풋잡	1	UTt	//기술
寝取られ	네토라레	1
寝取り	네토리	1
寝違え	잘못자서 삐끗함	1
ホドホド	적당	1
バクハツ	폭발	1
フトモモ	허벅지	1	VBp	//신체부위 :
大迫力	대박력	1
肉じゃが	고기감자조림	1	VFd	//음식(음료) : 伊月の肉じゃがに舌鼓を打ったのだった。
バンソーコー	반창고	1
味つけ	맛내기	1
ワンダホー	원더풀	1
真っ逆さま	완전히 역상[逆樣]	1	//東諒湾に真っ逆さまだという事を忘れることのなきよう。
真っ逆様	완전히 역상[逆樣]	1	//飛行機が真っ逆様に墜落する
一部屋	하나의 방	1	VPl	//장소 :
オートマティック	오토매틱	1
食べごたえ	식감	1
ぼったくり	바가지 씌우기	1
ぼっ手繰り	바가지 씌우기	1
あやめ園	붓꽃원	1	VPl	//장소 :
すました顔	시치미뗀 얼굴	1	VBp	//신체부위 :
大鎌	큰 낫	1	VPe	//도구
這々の体	기진맥진한 몸	1	VBp	//신체부위 :
片眼	편안[片眼]	1	VBp	//신체부위 :
べっかんこ	메롱	1
べっかんこう	메롱	1
あかんべえ	메롱	1
イマドキ	요즘	1
ハラペコ	배고픔	1
おとなり	이웃	1	VPl	//장소 : おとなりのお父さんとお母さんは、
夜ふかし	밤샘	1
服の替え	갈아입을 옷	1	VCp	//의복 : 服の替えは用意しておくように
気の使いすぎ	너무 신경 씀	1	//気の使いすぎは好ましくありません。
気の使い過ぎ	너무 신경 씀	1
いっかいだけ	한번 만	1	//いっかいだけ叶えられるんだよ
ほんすじ	본론	1	//ちょっとだけ物語のほんすじから外れた
大げんか	큰 싸움	1
顔馴染み	낯익은 사이	1
昼めし	점심	1	VFd	//음식(음료)
はだか	알몸	1
曇り空	흐린 하늘	1
忘れ物癖	건망증	1	UTi	//질병
色味	색감	1
金平糖	별사탕	1	VFd	//음식(음료)
コンビーフ	콘비프	1	VFd	//음식(음료)
みなごろし	몰살	1	//みなごろしにしようとする――
宙ぶらりん	엉거주춤	1	//部活に入ったのに宙ぶらりんみたいなこと。
私んとこ	나의 곳	1	VPl	//장소 : ♞ 俺んとこはあんまりなくってさ……
なかまはずれ	동료제외	1
時季はずれ	계절 벗어남	1
時季外れ	계절 벗어남	1
高台	고대[高台]	1
ひと押し	한번 밀기	1	//私は最後のひと押しをする為。
ひと噛み	한번 깨물기	1
ひと撫で	한번 쓰다듬기	1	//頬をひと撫でした。
ひと舐め	한번 빨기	1	//ひと舐めしたいです。
ひとっ風呂	한차례 목욕	1	//
ひと風呂	한차례 목욕	1	//
ひとやすみ	휴식	1
おないどし	동갑	1
悩み所	고민거리	1
何刻	몇 시각	1	UMe	//시간
厄介ごと	성가신 일	1
寝ぼけ顔	잠에서 덜 깬 얼굴	1
抜け駆け	몰래 앞질러 하기	1
雪片付け	눈치우기	1
手持ちかばん	손가방	1
的外れ	빗나감	1
休みボケ	휴일 휴우증	1
丸投げ	통째로 맡김	1
依代	의대[依代]	1
木の根	나무 뿌리	1
内股歩行	안짱다리 보행	1
アルカトラス	알카트라스	1
徹底ぶり	철저한 꼴	1
間尺	계산	1	//間尺に合わない。
鉄拳制裁	철권제재	1
各部位	각 부위	1
絶不調ぶり	컨디션 난조인 꼴	1
愚劣ぶり	어리석은 꼴	1
世まい言	넋두리	1
世迷い言	넋두리	1
世迷言	넋두리	1
絶不調	컨디션 난조	1
薄暗がり	어두침침함	1
朝飯	아침밥	1	VFd	//음식(음료)
かけ声	기합소리	1	UHr	//음성(음향)
教会跡	교회자취	1	VPl	//장소
爪の垢	손톱의 때	1
気分直し	기분 전환	1
目のやり場	눈 둘 곳	1
あら探し	흠집 찾기	1
身の入り	알맹이 상태[身の入り]	1
身入り	알맹이 상태[身の入り]	1
九尾	구미[九尾]	1
余裕綽々	여유만만	1
家族らしいこと	가족다운 일	1
家族らしい事	가족다운 일	1
決まり事	규칙	1
商人風情	상인 따위	1	//商人風情を連れてくるべきじゃなかった。
禁じ手	금기	1
人の風上	사람의 축	1	//人の風上にも置けない奴だな。
駄駄漏れ	줄줄 새어나감	1	//邪悪な気を駄々漏れにする魔物。
透る声	들리는 소리	1	UHr	//음성(음향)
音無き音	소리 없는 소리	1	UHr	//음성(음향)
超強力	초강력	1
梳き櫛	참빗	1
海鮮鍋	해물찌개	1	VFd	//음식(음료)
湧き水	용수	1
水汲み	물긷기	1
目障り	눈엣가시	1
桂剥き	돌려깎기	1
ウインナソーセージ	비엔나 소세지	1	VFd	//음식(음료)
ウィンナソーセージ	비엔나 소세지	1	VFd	//음식(음료)
ウインナ	비엔나	1
ウインナー	비엔나	1
ウィンナ	비엔나	1
ウィンナー	비엔나	1
もんじゃ焼き	몬자야키	1	VFd	//음식(음료)
付け焼刃	벼락치기	1
ママレード	마멀레이드	1	VFd	//음식(음료)
柏餅	카시와모찌	1	VFd	//음식(음료)
みたらし団子	미타라시 당고	1	VFd	//음식(음료)
角煮	카쿠만	1	VFd	//음식(음료)
のぞき見	엿보기	1
覗き見	엿보기	1
おみまい	병문안	1	//あとでスペシャルなのをおみまいするからね！
湯上がり	목욕 마침	1
湯上がり姿	목욕한 모습	1
令状	영장	1
万が一の時	만일의 경우	1
万が一のとき	만일의 경우	1
栄華の時	영광의 때	1
栄華の時間	영광의 시간	1
栄華の時代	영광의 시대	1	//栄華の時は訪れまいぞ！
不似合い	어울리지 않음	1
不似合	어울리지 않음	1
なりふり	외양	1	//なりふりかまわなくて品がないこと！
ほったらかし	내팽개침	1
放ったらかし	내팽개침	1
昼餉	점심	1	//ううう…折角の昼餉が…
顔型	얼굴형	1
ムラサキ色	보라색	1	UCr	//색상
キーマカレー	소고기 카레	1	VFd	//음식(음료)
お世話係	시중계	1
エロ本たち	애로책들	1	VBk	//책(도서)
預りもの	보관품	1	//♞預かりもの
預かり物	보관품	1
愚か極まり	어리석기 짝	1	//愚か極まりないぞ
インサイダー取引	내부자 거래	1
イマジネイション	이매지네이션	1
トゥルー	트루	1
霞草	안개꽃	1	QAL	//꽃이름(풀이름)
プレリュード	프렐류드	1
デミグラスソース	데미글라스 소스	1
チョークスラム	쵸크슬램	1
ヘヴン	헤븐	1	VPl	//장소
ですます調	데스마스조[ですます調]	1
若かりし頃	젊었을 무렵	1
キリマンジャロ	킬리만자로	1	QCT	//도시(지명)명
エムブレム	엠블럼	1
バルムンク	발뭉	1	VTw	//무기 : 『ニーベルンゲンの歌』に登場する剣。
ニーベルンゲン	니벨룽겐	1
手巻きタバコ	봉초담배	1
晴れ舞台	화려한 무대	1	VPl	//장소
色見本	색 견본	1	//親父が昔使ってた色見本チャートだよ。
三教科	3교과	1
炒物	볶음	1	VFd	//음식(음료)
蜜豆	미츠마메	1	VFd	//음식(음료)
煮魚	생선조림	1	VFd	//음식(음료)
揚げ魚	생선튀김	1	VFd	//음식(음료)
カラフル	컬러풀	1
体操座り	쭈그려 앉기	1
体育座り	쭈그려 앉기	1
煮凝り	생선조림	1	VFd	//음식(음료)
煮凝	생선조림	1	VFd	//음식(음료)
煮こごり	생선조림	1	VFd	//음식(음료)
スムージー	스무디	1	VFd	//음식(음료)
ばら寿司	바라즈시	1	VFd	//음식(음료)
小籠包	샤오롱바오	1	VFd	//음식(음료)
豚の角煮	돼지고기 조림	1	VFd	//음식(음료)
辣韮	락교	1	VFd	//음식(음료)
外付けハード	외장하드	1
チェンジング	체인징	1
早回し	빨리 감기	1
ジャマー	재머	1
利き腕	잘 쓰는 손	1	VBp	//신체부위
ヘッドバッド	헤드벗	1
最深層	최심층	1
八割	8할	1
フレグランス	프레이그런스	1
房中術	방중술	1	UTt	//기술
姉妹丼	자매덮밥	1	VFd	//음식(음료)
母女丼	모녀덮밥	1	VFd	//음식(음료)
面白半分	재미 반	1	//
似顔絵	초상화	1	VSp	//그림 : おもしろ半分に似顔絵をかく
カルカソンヌ	카르카손	1
採寸表	치수표	1
クレイドル	클레이들	1
正真正銘	정진정명[正眞正銘]	1
御庭番衆	오니와반슈	1
お庭番衆	오니와반슈	1
ヤンキーゴーホーム	양키고홈	1
四無量心	사무량심[四無量心]	1
棚からぼた餅	굴러들어온 떡	1	VFd	//음식(음료)
棚ボタ	굴러들어온 떡	1	VFd	//음식(음료)
棚ぼた	굴러들어온 떡	1	VFd	//음식(음료) : 棚ぼたっつーか。
和歌山	와카야마	1	VPl	//장소
チャレンジャブル	챌린저블	1
レディースコミック	레이디스 코믹	1	VBk	//책(도서)
平安京	헤이안쿄	1	VPl	//장소
カルパッチョ	카르파초	1	VFd	//음식(음료)
櫻の園	벚꽃 동산	1	VPl	//장소
カップやきそば	컵 야키소바	1	VFd	//음식(음료)
唐竹割り	당죽 가르기	1
双手刈り	다리잡아 메치기	1
炒飯	볶음밥	1	VFd	//음식(음료)
干魚	건어	1	VFd	//음식(음료)
干し魚	건어	1	VFd	//음식(음료)
乾し魚	건어	1	VFd	//음식(음료)
ぬかよろこび	헛된 기쁨	1
君が代	키미가요	1	USo	//노래
タナボタ	굴러들어오는 복	1
津津浦々	방방곡곡	1	//♞津々浦々
明滅	명멸[明滅]	1
叫喚	규환	1
ペチャパイ	절벽가슴	1	VBp	//신체부위
ペチャパイッ	절벽가슴	1	VBp	//신체부위
オレオレ詐欺	보이스피싱	1
亀の甲羅	거북이 등껍질	1
曰くつき	나쁜 사정이 얽힘	1
あぶらあげ	유부	1
油揚げ	유부	1
やたらめったら	엉망진창	1	//俺はやたらめったらに槍を振り回す！
お兄ちゃんごっこ	오빠놀이	1
お医者さんごっこ	의사놀이	1
渾身の出来	혼신의 성과	1
羽ばたき音	날개짓 소리	1	UHr	//음성(음향)
ブルースクリーン	블루 스크린	1
責め甲斐	괴롭히는 보람	1
姫花弁	희화판[姬花弁]	1
睨み	눈초리	1	//睨む 가 동사일 경우는 필터링에서 にらみ로 바뀌었음.
塵一つ	티끌 하나	1
筒ぬけ	누설	1	//きっと全てリアンに筒ぬけなんだ。
真実み	진실성	1
御神体	신체	1
人智	인지	1
坦々麺	탄탄면	1	VFd	//음식(음료)
海鮮	해산물	1	VFd	//음식(음료)
ボルダリング	볼더링	1
糞溜め	똥구덩이	1
まとめ買い	대량구매	1
袋ラーメン	봉지 라면	1	VFd	//음식(음료)
寝技	굳히기	1
野宿	야숙	1	//我ながら野宿しなれている。
冷やし中華	비빔면	1	VFd	//음식(음료)
モールス	모스	1
コンバス	컨버스	1
コンペイトウ	별사탕	1	VFd	//음식(음료)
こんぺいとう	별사탕	1	VFd	//음식(음료)
コンペイとう	별사탕	1	VFd	//음식(음료)
肩揉み	어깨 안마	1
ナンクセ	트집	1
天丼	튀김덮밥	1	VFd	//음식(음료)
花鳥盛り	화조담기	1	VFd	//음식(음료)
花鳥風月	화조풍월	1
フローラル	플로럴	1
インセクト	인섹트	1
民百姓	민백성	1
息使い	숨결	1
肩先	어깻죽지	1	VBp	//신체부위
杏仁豆腐	행인두부	1	VFd	//음식(음료)
腕マクラ	팔베게	1
白みそ	백된장	1	VFd	//음식(음료)
北京ダッグ	북경 오리	1	VFd	//음식(음료)
深追い	지나친 추적	1
銀はがし	은박 벗기기	1	//ねぇハンバーガー屋でもらった銀はがしやる？
棒振り剣術	엉터리 검술	1
慌てっぷり	당황하는 모습	1
あわてっぷり	당황하는 모습	1
腕ぐみ	팔짱	1
三号棟	3호동	1	VPl	//장소
ジンクホワイト	징크 화이트	1	UCr	//색상
茶葉	찻잎	1
コマンド	커맨드	1
プレイングマニュアル	플레잉 매뉴얼	1
ビーフシチュ	비프 스튜	1	VFd	//음식(음료)
オマージュ	오마주	1
トワイライト	트와일라이트	1
​ブルーム	블룸	1
​レスキュー	레스큐	1
フットワーク	풋 워크	1
デルフィニウム	델피늄	1	VPt	//식물
カトレア	카틀레야	1	VPt	//식물
​ムーンフラワー	문플라워	1	VPt	//식물
三種の神器	삼종의 신기	1
月会費	월회비	1
願い下げ	사절	1	//こちらこそ願い下げです
早解き	빨리 풀기	1
ディフェンディング	디팬딩	1
恨み節	원망	1	UFl	//감정
巻き毛	곱슬머리	1
返り血	튀어나온 피	1	VLq	//액체 : 返り血を浴びていない
瞬殺	순살[瞬殺]	1	//瞬殺された
北京ダック	북경오리	1	VFd	//음식(음료)
アルタイル	알타이르	1
箱舟	방주	1	VTp	//교통수단
タクティカル	택티컬	1
アンハッピー	언해피	1
ペドフィリア	페도필리아	1	UTi	//질병
あさっての方向	엉뚱한 방향	1
中華鍋	중화냄비	1
ゲシュタルト	게슈탈트	1
術法	술법	1
手裏剣	수리검	1	VTw	//무기
撒菱	마키비시[撒菱]	1	//닌자가 도망칠 때 땅바닥에 뿌리는 도구.
マニピュレータ	매니퓰레이터	1
トランキライザー	트랭퀼라이저	1	VMd	//약품
ハウリング	하울링	1
ヴァイオレット	바이올렛	1
スパロウ	스패로우	1
ジェノサイド	제노사이드	1
ボトルシップ	보틀쉽	1
トーテムポール	토템폴	1
ローリングソバット	롤링 소배트	1
ギムナジウム	김나지움	1
アンコモン	언커먼	1
文金高島田	분킨타카시마다[文金高島田]	1
開発工事	개발공사	1
トンファー	톤파	1
昆布巻き	다시마 말이	1	VFd	//음식(음료)
ジュラルミン	두랄루민	1	VMa	//소재
邪気眼	사기안[邪氣眼]	1
ディザスター	디재스터	1
リビルディング	리빌딩	1
キャラメルラテ	캬라멜라떼	1	VFd	//음식(음료)
カタクリ	얼레지	1	VPt	//식물
後じさり	뒷걸음질	1
におい袋	향주머니	1
キャリーカート	캐리카트	1
家内安全	가내안전	1
巻き寿司	마키즈시	1	VFd	//음식(음료)
霧吹き	분무기	1
乾燥わかめ	마른 미역	1	VFd	//음식(음료)
がむしゃら	다짜고짜	1	//自滅覚悟のがむしゃらの一撃。
エキシビジョン	엑시비션	1	VPl	//장소
浮き輪	튜브	1
砂利道	자갈길	1	VPl	//장소
髪留め	머리핀	1
流し台	설거지대	1
ホンオ・フェ	홍어회	1	VFd	//음식(음료)
黄昏時	해질녘	1	UMe	//시간
笑いのツボ	웃음 포인트	1
メディカルセンター	메디컬 센터	1	VPl	//장소
二つ名	이명[二つ名]	1
寝屋	침실	1	VPl	//장소
寝屋川	네야가와	1	QCT	//도시(지명)명
バトントワリング	배턴 트윌링	1
キャラコスプレ	캐릭터 코스프레	1
裏指導	뒷지도	1
ジャスティスブレイド	저스티스 블레이드	1
記憶ショーガイ	기억장애	1
ひとつご忠告	하나 충고	1
一つご忠告	하나 충고	1
ラヴコール	러브콜	1
煮込みハンバーグ	햄버그 스테이크	1	VFd	//음식(음료)
捜しもの	찾는 것	1
焼き菓子	구운 과자	1	VFd	//음식(음료)
お小遣い帳	용돈 출납장	1	VBk	//책(도서)
焼きたてパン	갓 구운 빵	1	VFd	//음식(음료)
早見盤	별자리판	1
ヴァリアント	발리안트	1
蚤取り	벼륙잡기	1
下拵え	사전준비	1
ずる休み	땡땡이	1
ズル休み	땡땡이	1
通り雨	지나가는 비	1
かごめかごめ	카고메카고메	1	//일본 애들이 하는 놀이할 때 하는 말이라 함.
焼き討ち	화공	1
ちょこちょこばしり	종종걸음으로 뛰기	1
マナザシ	시선	1
尻すぼみ	용두사미	1	//20世紀少年 尻すぼみ。
尻窄み	용두사미	1	//20世紀少年 尻すぼみ。
四足歩行	4족 보행	1
喉ごし	목넘김	1
合い挽き肉	저민 고기	1	VFd	//음식(음료)
遣り取り	주고 받기	1
シャンプーハット	샴푸 모자	1
育ち盛り	한창 자랄 때	1	UMe	//시간
育ちざかり	한창 자랄 때	1	UMe	//시간
カサブタ	딱지	1	//상처에 생기는 것
刈込み	가지치기	1
一挙手一挙動	일거수일투족	1
分度器	각도기	1
オシャカ	불량품	1
悪魔憑き	악마빙의	1
地稽古	상호연습	1	//검도 용어
逢い引き	밀회	1
夜回り	야간 순찰	1
待ちあわせ場所	약속 장소	1	VPl	//장소
餅つき	떡치기	1
片ひじ	한쪽 팔꿈치	1	VBp	//신체부위
片肘	한쪽 팔꿈치	1	VBp	//신체부위
インフルエンザ	인플루엔자	1
リンパ球	림프구	1
食器洗い	설거지	1
置き傘	예비 우산	1
困惑顔	곤혹스런 얼굴	1
ミートローフ	미트로프	1	VFd	//음식(음료)
使いっ走り	잔심부름	1
かき揚げ	카키아게	1	VFd	//음식(음료)
お召し替え	갈아입음	1	//동사 召し替える 는 거의 안 쓰이는 듯.
お昼過ぎ	오후	1	UMe	//시간 : またお昼過ぎに目が覚めた。
濃緑色	진녹색	1	UCr	//색상
抗うつ薬	항우울제	1	VMd	//약품
抗うつ	항우울	1
お米の飯	쌀밥	1	VFd	//음식(음료)
エロ本知識	에로책 지식	1
ふかひれ	상어 지느머리	1	VFd	//음식(음료) : ふかひれスープ
長机	긴 책상	1	VFn	//가구
どんちゃん騒ぎ	야단법석	1	//명사라함.
さしすせそ	사시스세소	1
あいうえお	아이우에오	1
現生徒会	현 학생회	1	//現生徒会役員。
お菓子類	과자류	1	VFd	//음식(음료)
ヤケクソ	자포자기	1
自棄糞	자포자기	1
蛇口	수도꼭지	1
羞じらい	수줍음	1
来校	내교	1
腹立ち紛れ	홧김	1	//腹立ち紛れに目の前のフェンスを蹴飛ばした。
厄介払い	귀찮은 것 털어버림	1
きんぴらゴボウ	우엉 조림	1	VFd	//음식(음료) :
立て付け	열리고 닫힘	1
拡張子	확장자	1
水だまり	웅덩이	1
百万石	백만석	1	//三百万石
鍔下	차양 아래	1	//帽子の鍔下から覗く鋭い視線。
双刃	쌍날	1	//双刃の槍
光刃	광인[光刃]	1
一筋の光刃	한 줄기의 광인[光刃]	1
のろけ話	애인 자랑하는 이야기	1
一踏ん張り	조금만 더 분발함	1
底無し沼	바닥 없는 늪	1	VPl	//장소
ビヤ樽	맥주통	1
専らの噂	한결같은 소문	1
わしづかみ	움켜잡음	1
年寄扱い	노인 취급	1
共栄	공영	1
いけいけモード	가버리자 모드	1
行け行けモード	가버리자 모드	1
イケイケモード	가버리자 모드	1
ひと抱え	한 아름	1
魔境	마경	1
芋飴	고구마엿	1	VFd	//음식(음료)
それどころ	그럴 곳	1	//今はもうそれどころじゃない。それどころの問題ではなかった。お礼もいわない.それどころか悪口をいう始末だ
騎航	기항	1
後背部	배후부	1
咳一つ	기침 하나	1
派手柄	화려한 무늬	1
平伏	평복[平伏]	1
面目躍如	면목약여[面目躍如]	1
竹林	대나무숲	1	VPl	//장소
ガトリングガン	개틀링건	1	VTw	//무기
万に一個	만에 하나	1	//♞万に一つ
万に一つ	만에 하나	1	//
雪隠詰め	막다른 길에 몰아넣음	1
石積み	돌쌓기	1
一閃万里	일섬만리	1
血糊	피	1
膝立ち	무릎서기	1
誰何	수하[誰何]	1
逆座	역좌[逆座]	1
夕空	저녁 하늘	1
刀子	작은 칼[刀子]	1	VTw	//무기
鬼面	귀면[鬼面]	1
小村	작은 마을	1	VPl	//장소
血沼	피의 늪	1	VPl	//장소
刀牙	도아[刀牙]	1
右肘	오른쪽 팔꿈치	1	VBp	//신체부위
左肘	왼쪽 팔꿈치	1	VBp	//신체부위
対極の側	대극의 측	1
足回り	발 언저리	1
一手馳走	한 수 대접	1
点前	점전[点前]	1
読み合い	수싸움	1
大長刀	대장도	1	VTw	//무기
神宝	신성한 보물	1
生まんこ	생보지	1	VBp	//신체부위
大坂城	오사카성	1	VPl	//장소
遅れ馳せ	뒤늦음	1
尋常一様	범상함	1
針山	바늘꽂이	1
冗句	쓸데없는 구절	1
政道批判	정도비판	1
刃味	칼 맛	1
腰ぎんちゃく	허리주머니	1
腰巾着	허리주머니	1
炊き加減	익힌 정도	1
軋み音	삐걱거리는 소리	1	UHr	//음성(음향)
掌底	장저[掌底]	1
空拭き	마른 걸레질	1
帰投	귀환	1
峰打ち	칼등치기	1
前転	앞구르기	1
後転	뒷구르기	1
手妻	요술	1
めった打ち	난타	1
立木打ち	나무치기	1
出羽三山	데와3산	1	VPl	//장소
勝手絶頂	제멋대로 절정	1	//なんでこの野郎は勝手絶頂にしてられる
石塊	돌덩어리	1
腕立て伏せ	팔굽혀펴기	1
うでたてふせ	팔굽혀펴기	1
きりたんぽ	떡꼬치구이	1
魂送り	혼령 달래기	1
当然至極	당연지사	1
拝察	배찰[拜察]	1
徒労感	헛수고감	1
俄か雨	소나기	1
御酌量	참작	1
射線	사선	1


//할 수 없이 상용어구로 등록 ('명)
元気な盛り	건강한 한창 때	0
すんでのところ	위기의 순간	0	UMe	//시간 : 할수없이 상용어구 등록...
若しものこと	예기치 못한 일	0
もしものこと	예기치 못한 일	0
きつい目	엄한 눈	0	VBp	//신체부위 :
一緒くた	뒤섞음	0	//花も雑草も一緒くたに抜く
最後の砦	최후의 보루	0
一生懸命さ	최선을 다함	0
我が物顔	자기 것인양	0
おもらし	오줌 흘리기	0
真っ直ぐな瞳	똑바른 눈동자	0	//この娘の真っ直ぐな瞳から、目を背けてはいけない。
大の字	대자[大の字]	0	//携帯を閉じてベッドに大の字になる。
いやなよかん	싫은 예감	0	//いやなよかんがするコースは駅までコース。
あの日の出会い	저 날의 만남	0
だめさ加減	모자란 정도	0
かつらむき	돌려깎기	0
かつおぶし	가다랭이포	0	VFd	//음식(음료)
赤いもみじ	붉은 단풍	0
長長話	긴 이야기	0
いか程の時間	얼마나의 시간	0	UMe	//시간 : されてから、いかほどの時間がたったか。
いか程なもの	어느 정도의 것	0	//如何ほどなものか。
幼い時分	어린 시절	0

//'명사 끝








//█████████████████████████████████████████████████████████████████████████████
// #.형용사, 부사
//█████████████████████████████████████████████████████████████████████████████
//[なのに] '형용사 및 '부사
あのていどの	저 정도의	0	//このていどの展開
あのように	그처럼	0
あの様に	그처럼	0
あべこべな	뒤바뀐	0
あべこべに	뒤바뀌게	0
あべこべの	뒤바뀐	0
いい加減な	적당한	0
いくばくかの	약간의	0
いつのまに	어느새	1
おしずかに	조용히	0
おためごかしの	남을 위해주는 체하는	0
からかいの	놀림의	0
カラッカラに	바짝바짝하게	0
からっからに	바짝바짝하게	0
がらんどうな	텅 빈	0
がらんどうの	텅 빈	0
きゅうに	갑자기	0
ケタ違いの	격이 다른	0
けったいな	희안한	0
こてんこてんに	철저히	0
こてんばんに	철저히	0
このていどの	이 정도의	0	//このていどの展開
さみしげに	쓸쓸한 듯이	0
さりげに	태연하게	0	//さりげに嘘ついちゃだめよってばよ
しあわせな	행복한	0
しあわせに	행복하게	0
じきじきに	직접	0
セレブな	귀티나는	0
そうそうに	서둘러	0
そぞろに	어쩐지	0
そのていどの	그 정도의	0	//このていどの展開
そのように	그처럼	0
その度に	그때마다	0
その様に	그처럼	0
ただ単に	단지 그저	0
チャキチャキの	진정한	0
ちゃきちゃきの	진정한	0
ドサクサに	혼잡하게	0
どさくさに	혼잡하게	0
なにげに	무심코	0
なんとはなしに	왠지 모르게	0
なんとは無しに	왠지 모르게	0
ひたすらに	오로지	0
ほんのわずな	그저 얼마 안 되는	0
ムフフな	므흣한	0
モノホンの	진품의	0	//甘えんぼでお兄ちゃんっ子だったはずのモノホンのアイツが
わずかな	얼마 안 되는	0
間髪入れずに	지체없이	0
甘めな	달달한	0
甘めに	달달하게	0
甘めの	달달한	0	//甘めの顔立ち
高級そうな	고급인듯한	0
瓜二つの	쏙 빼닮은	0	//瓜二つの顔の二人
校内一の	교내 제일의	0
弓なりに	활처럼	0
僅かに	조금	0
気遣わし気に	신경쓰이는 기분으로	0
気付かれずに	눈치채지 못하게	0
女だてらに	여자답지 않게	0
濃いめの	진한	0
当然とばかりの	당연하다는 듯이	0
代わる代わるに	번갈아가며	0
徒らに	부질없이	0
麗しの	아름다운	0	//麗しのマドンナ。
露わに	공공연하게	0
晩くに	늦게	0
満ち満ちに	가득가득히	0
満悦そうな	만족스러운듯한	0
無下の	하찮은	0
美しの	아름다운	0
悶々の	번민의	0
悶悶の	번민의	0
剥きだしの	노출된	0
粉々に	산산히	0
粉粉に	산산히	0
使い古しの	낡은	0
手つかずの	손대지 않은	0
矢継ぎ早に	잇달아	0
十二分に	충분히	0
我勝ちに	앞다투어	0
愛しの	사랑스러운	0
言い出しっぺの	먼저 말을 시작한 사람인	0
円を描くような	원을 그리는 듯한	0	//円を描くようにして彼女の口腔を支配する。
円を描くように	원을 그리듯이	0	//円を描くようにして彼女の口腔を支配する。
然りげに	태연하게	0
熱々の	뜨거운	0
遠回しな	완곡한	0
遠回しに	완곡하게	0
肉厚の	두툼한	0
飲みかけの	마시다 만	0
飲み掛けの	마시다 만	0
伊達の	겉멋부림의	0
程程に	적당히	0
早々に	조속히	0
直々に	직접	0
真っ先に	가장 먼저	0
千々に	이것저것에	0
初めての時のような	처음과 같은	0
初めての時のように	처음과 같이	0
恥ずかしの	부끄러운	0
何とはなしに	왠지 모르게	0
何とは無しに	왠지 모르게	0
何気に	무심코	0
学園一の	학원 제일의	0
丸わかりに	뻔히 보이게	0
丸わかりの	뻔히 보이는	0
嬉し恥ずかしの	기쁘고 부끄러운	0
希代な	희안한	0
雨ふりの	비오는	0	//雨ふりの歌
ゆゆしき	중대한	0	//ゆゆしき問題
死にたがりの	죽고 싶어하는	0	//どうも、死にたがりの狂人ね
蒼き	푸른	0	//蒼き硝煙
アヤシゲな	수상한	0
なげやりな	자포자기인	0	//なげやりな苦笑を浮かべている
出来たての	갓 만들어진	0	//出来たての料理を並べる
いいように	좋을대로	0	//いいように操られましょう
いたずらげに	장난스럽게	0
サイン入りの	사인이 들어있는	0
意味深に	의미심상하게	0
意味深な	의미심상한	0
まことしやかに	그럴듯하게	0
まことしやかな	그럴듯한	0
嬉しい恥ずかしな	기쁘고 부끄러운	0	//♞嬉し恥ずかしな昼食時間は、平和に過ぎていった。
切なげに	안타깝게	0
切なげな	안타까운	0
得意げな	우쭐해하는	0
しぜーんに	자연스럽게	0
円らな	동그란	0	//円らな瞳
小意気な	멋진	0
常識外れな	상식에서 벗어난	0	//これまで体験したことのない常識外れな大騒動に胸を躍らせていく
ごくごくの	극도의	0	//ごくごくのひみつ
苛立たしげな	초조한 듯한	0
苛立たしげに	초조한 듯이	0
へいわな	평화로운	0	//
おりこうな	영리한	0	//おりこうなモーショントラッキング・カメラ
じゃれ合いの	서로 장난치는	0	//じゃれ合いの最中に触れた手足の感触に劣情を一切覚えなかったと言えば嘘になる。
朴訥な	소박한	0	//朴訥な人だよな
熱々に	뜨겁게	0
コテンパンに	무참하게	0	//今日こてんぱんに負けちゃったのは、
こてんぱんに	무참하게	0	//今日こてんぱんに負けちゃったのは、
ホドホドに	적당히	0
ふきげんな	언짢은	0
らんぼうな	난폭한	0	//らんぼうな方法でなきゃ起きないのかと思った
しょうじきな	정직한	0
しょうじきに	정직하게	0
とくべつな	특별한	0
とくべつに	특별히	0
興味深げな	흥미 깊은듯한	0
興味深げに	흥미 깊은듯이	0
まんまるの	둥그런	0	//まんまるの月が光ってて
中々に	꽤	0
中中に	꽤	0
なかなかに	꽤	0
内内に	은근히	0
内々に	은근히	0
すべらかな	미끌미끌한	0
結構な	상당한	0
不満そうな	불만인듯한	0


//◆トタリ형 '형용사
//▀▀▀▀▀▀▀▀▀▀▀▀▀▀▀▀▀▀▀▀▀▀▀▀▀▀▀▀▀▀▀▀▀▀▀▀▀▀▀▀▀▀▀▀▀▀▀▀▀▀▀▀▀▀▀▀▀▀▀▀▀▀▀▀▀▀▀▀▀▀▀▀▀▀▀▀▀
かくしゃくたる	건장한	0
かくしゃくと	건장하게	0
がく然	아연실색	1	//愕然
モンモンと	번민스럽게	0
もんもんと	번민스럽게	0
らんらんと	반짝반짝	0
高らかたる	드높은	0
高らかと	드높이	0
恐々と	두려워하며	0
気息奄々たる	숨을 할딱거리는	0
気息奄奄たる	숨을 할딱거리는	0
気息奄々と	숨을 할딱거리며	0
気息奄奄と	숨을 할딱거리며	0
訥々と	더듬더듬	0
段々と	점점	0
爛々たる	형형한	0
爛爛たる	형형한	0
爛々と	형형하게	0
爛爛と	형형하게	0
朗々と	낭랑하게	0
冷然と	냉정히	0
隆々たる	융성한	0
隆々と	융성하게	0
茫然たる	망연한	0
茫然と	망연히	0
呆然たる	어안이 벙벙한	0
呆然と	어안이 벙벙히	0
名立たる	유명한	1
悶々たる	번민하는	0
悶悶たる	번민하는	0
悶々と	번민스럽게	0
悶悶と	번민스럽게	0
馥郁たる	그윽한	0
馥郁と	그윽히	0
散々たる	산산조각난	0	//その結果、散々たる敗北を与えられ
潸々と	주륵주륵	0
潸潸と	주륵주륵	0
颯爽たる	씩씩한	0
颯爽と	씩씩하게	0
生生たる	생생한	0
騒然と	어수선하게	0
奄々たる	할딱거리는	0
奄奄たる	할딱거리는	0
奄々と	할딱거리며	0
奄奄と	할딱거리며	0
易々と	거뜬히	0
易易と	거뜬히	0
艶々と	반들반들	0
傲然と	오만하게	0
鬱々と	우울하게	0
鬱鬱と	우울하게	0
鬱蒼と	울창하게	0
悠然たる	유연한	0
悠然と	유연히	0
長長と	장황히	0
燦々たる	찬란한	0
燦燦たる	찬란한	0
燦々と	찬란히	0
惨憺たる	처참한	0
青々と	푸릇푸릇	0
青青と	푸릇푸릇	0
楚々たる	청초한	0
楚楚たる	청초한	0
楚々と	청초하게	0
楚楚と	청초하게	0
楚々とした	청초한	0
楚楚とした	청초한	0
炯々と	형형하게	0
和気藹々たる	화기애애한	0
和気藹々と	화기애애하게	0
矍鑠たる	건장한	0
矍鑠と	건장하게	0
黒々たる	시커먼	0
黒々と	시커멓게	0
喜々と	희희낙락	0	//(きき) : 喜々として犯される淫夢だった。喜々として泳ぎ回る影。
喜喜と	희희낙락	0	//(きき) : 喜々として犯される淫夢だった。喜々として泳ぎ回る影。
嬉々と	희희낙락	0	//(きき) : 喜々として犯される淫夢だった。喜々として泳ぎ回る影。
嬉嬉と	희희낙락	0	//(きき) : 喜々として犯される淫夢だった。喜々として泳ぎ回る影。
飄々と	홀연히	0
飄々たる	홀연한	0
嫣然と	싱긋	0
延々	계속	0	//延々3時間にわたった淀川さんへのインタビュー。ずっと延々あたしがデレなかったおかげで
滔々と	거침없이	0
滔々たる	거침없는	0
煌々と	형형히	0
煌々たる	형형한	0
和気藹々	화기애애	0
和気藹々と	화기애애하게	0
和気藹々たる	화기애애한	0
玲瓏と	영롱하게	0
玲瓏たる	영롱한	0
蕭々と	스산하게	0
蕭々たる	스산한	0
暗々と	어둡게	0
暗々たる	어두운	0
陰々と	음산하게	0
陰々たる	음산한	0
陰陰と	음산하게	0
陰陰たる	음산한	0
諾諾と	고분고분하게	0
諾諾たる	고분고분한	0
諾々と	고분고분하게	0
諾々たる	고분고분한	0
忸怩と	창피스럽게	0
忸怩たる	창피스러운	0
緩々と	유유히	0
緩々たる	유유한	0


//그외 '형용사 및 '부사 및 접속사
//▀▀▀▀▀▀▀▀▀▀▀▀▀▀▀▀▀▀▀▀▀▀▀▀▀▀▀▀▀▀▀▀▀▀▀▀▀▀▀▀▀▀▀▀▀▀▀▀▀▀▀▀▀▀▀▀▀▀▀▀▀▀▀▀▀▀▀▀▀▀▀▀▀▀▀▀▀
嬉しからざる	기쁘지 않은	0
望ましからざる	바람직하지 않은	0
イカした	멋졌던	0
イカす	멋진	0
いっ～ぱい	가~득	0
いっーぱい	가-득	0
イマイチ	좀 더	0
いまいち	좀 더	0
うすら	엷은	0
うら若き	젊디 젊은	0
かくして	이리하여	0
かな～り	꽤	0
かなーり	꽤	0
からきし	전혀	0
からっきし	전혀	0
こういうと	이렇게 말하면	0	//こういうと失礼だけ
ここんとこ	요즘	0
ことのほか	의외로	1
さっすが	과연	0
さてこそ	그러고보니	0
じばらく	당분간	0
しばらくぶり	오랜만	0
しんとした	고요한	0
ズイブン	상당히	0
ずい分	상당히	0
ぜっかく	모처럼	0
ゼンブ	전부	0
そういうと	그렇게 말하면	0
そこんとこ	그 점	1
そやけど	그렇지만	0
たぁっぷり	충분히	0
ためつすがめつ	꼼꼼히	0	//シンシアが手紙をためつすがめつ眺める。
ちょっとずつ	조금씩	0
つまるところ	결론적으로	0	//つまるところマスターであるヴァンパイアの眷族です
つまるところは	결론적으로는	0
でもでも	그렇지만 그렇지만	0
どうなりと	어떻게든	0
なーるほど	과-연	0
なおかつ	더 한층	0
なんじょうこと	무슨 일	0	//なんじょうことも侍らず
なんじょうもってこと	무슨 일	0	//なんじょうもってことも侍らず
なんじょうもってのこと	무슨 일	0	//なんじょうもってのことも侍らず
なんじょうもっての事	무슨 일	0	//なんじょうもっての事も侍らず
なんじょうもって事	무슨 일	0	//なんじょうもって事も侍らず
なんじょう事	무슨 일	0	//なんじょう事も侍らず
なんにせよ	어쨌든	0
ひと際	한층 더	0
ほんのわずか	아주 조금	1
ほんの僅か	아주 조금	1
まざまざ	역력	0
まだしも	그래도	0
またぞろ	지겹게 또	0
まるきり	완전	0
まるっきり	완전	0
もう少しだけ	조금만 더	0
ゆっくりと	천천히	0	//ゆっくりと眠りに落ちていった
侃々諤々と	기탄없이	0
綺麗さっぱり	완전히	0	//綺麗さっぱりなくさない内からそんなことする
きれいさっぱり	완전히	0	//きれいさっぱりなくさない内からそんなことする
道々	길을 가면서	0	//そして道々談笑する貴族たち。
毛頭	털끝만큼도	0
斯くして	이리하여	0
仕し方なき	어쩔 수 없는	0
尚さら	더욱 더	0
嘗て	일찍이	0
尚一層	더 한층	0
尚且つ	더 한층	0
所狭しと	가득	0
時おり	가끔	0
悉く	모조리	0	//ことごとく
沁沁	절절히	0
如何のこうの	이러쿵 저러쿵	0	//如何の斯うの -> 如何のこうの
如何斯う	이러쿵 저러쿵	0
然りとも	그렇다해도	0
然乍ら	마치	0	//さながら
宛ら	마치	0	//さながら
尤も	무엇보다	0
一度たりと	한번도	0
一度たりとも	한번도	0
暫くぶり	오랜만	0
暫く振り	오랜만	0
足繁く	빈번하게	0	//(あししげ)
呪われし	저주 받은	0
止めどとなく	하염없이	0
真っ直ぐ	곧바로	0
総て	모두	0	//すべて
兎に角	어쨌든	0
何がさて	하여간	0
何だかんだ	이러니 저러니	0	//何だかんだ言っても
何ゆえ	어찌하여	0
何條こと	무슨 일	0	//何條ことも侍らず
何条こと	무슨 일	0	//何条ことも侍らず
何條もってこと	무슨 일	0	//何條もってことも侍らず
何条もってこと	무슨 일	0	//何条もってことも侍らず
何條もってのこと	무슨 일	0	//何條もってのことも侍らず
何条もってのこと	무슨 일	0	//何条もってのことも侍らず
何條もっての事	무슨 일	0	//何條もっての事も侍らず
何条もっての事	무슨 일	0	//何条もっての事も侍らず
何條もって事	무슨 일	0	//何條もって事も侍らず
何条もって事	무슨 일	0	//何条もって事も侍らず
何條事	무슨 일	0	//何條事も侍らず
何条事	무슨 일	0	//何条事も侍らず
丸きり	완전	0
丸っきり	완전	0
丸っ切り	완전	0
丸切り	완전	0
荒ぶる	난폭한	0
いっその事	차라리	0
かっちりした	다부진	0	//そこまでかっちりした躾は受けてないんで
かっちりして	다부져	0
謂われ無い	말할 수 없는	0	//♞謂われ無き
それが故に	그런 연유로	0
程なく	이윽고	0
程無く	이윽고	0
願いたき	부탁하고 싶은	0
にっくき	얄미운	0	//少なくともあたしは練習の時いつもにっくき太陽め、早く沈めって願ってたけど
だ、か、ら	그, 러, 니, 까	0
割りかし	비교적	0
わりかし	비교적	0
矢っ張り	역시	0
全く以て	완전히	0
全くもって	완전히	0
モチロン	물론	1
とてもとても	너무나 너무나	0	//とてもとてもへいわな世界のお話。
今以て	아직도	0
なんやかや	이것저것	0	//なんやかや言われたって、これがいつもの当たり前で、
ちょっくら	조금	0	//ちょっくら大胆に行ってくるっす！
ちょこっと	조금	0	//たかがちょこっと勉強教えてあげただけじゃない
早いとこ	재빨리	0
ぶっきら棒	무뚝뚝	1	//ぶっきら棒な返答。
よーやく	겨우	0
少しばかし	조금	0	//少しばかし調子が良すぎやしねえかい
てんやわんや	야단법석	0
てんやわんやな	야단법석인	0
さぁっさと	빠알리	0
幾ばく	얼마	0	//幾ばくの金を寄付する
絆深き	인연이 깊은	0	//絆深き者
紛うことなき	혼동할 일 없는	0
恥ずべき	부끄러워 해야 할	0
有り体に	있는 그대로	0
隈なく	샅샅이	0
成る程	과연	0
成るほど	과연	0
トモカク	어쨌든	1	//가타카나를 상용어구로 하는건 좋지 않음 : 楽しいか楽しくないかはトモカクだ。
とっかえひっかえ	이리 바꾸고 저리 바꾸고	0
やむなき	어쩔 수 없는	0	//やむなき理由。
たけなわの	절정의	0
たけなわな	절정인	0	//紛争たけなわな頃の東ヨーロッパですわ！
たけなわに	절정에	0	//酒宴がたけなわになったころ
ちょ～っと	조~금	0
恐ろしき	두려운	0
押しなべて	대체로	0
果てなき	끝없는	0
隠密裏に	은밀리에	0


//▰ ~て、~と '부사
あらわと	공공연하게	0	//今度は露わとなった小さな割れ目が
あんって	앙	0
イヤイヤと	싫어싫어하고	0
いらっと	울컥	0
うーんと	음	0
うるっと	울컥	0
えへへと	에헤헤	0
えへんと	에헴	0
かあっと	확	0
かくんと	덜컥	0
カッカッと	캇캇	0
かっかっと	캇캇	0
がっしりと	튼튼하게	0
がつんと	콱	0
がばっと	벌떡	0
きちっと	확실히	0
キチンと	제대로	0
ぎゅうぅっと	꽈악	0
ぎゅうって	꾸욱	0
キュウッと	꽈악	0
ぎゅぅっと	꽈악	0
ぎゅうっと	꽈악	0
きゅーんって	쿵	0	//胸がきゅーんってしちゃった！
ぎゅっぎゅと	꾹꾸욱	0
ぎゅって	꽉	0	//んと……ぎゅって持って、ゴシゴシ擦るんだよね？
きゅんきゅんと	뜨끔뜨끔	0
きゅんっと	뜨끔	0
きゅんと	뜨끔	0
キョトンと	멍청히	0
キョトーンと	멍청히	0
きょんと	어리둥절	0
きらっと	반짝	0
きりっと	야무지게	0
ぎりっと	으득	0
キリリと	꽉	0
くいっと	꾸욱	0
ぐいっと	꾸욱	0
くくっと	쿠쿡	0
ぐさっと	푸욱	0
ぐすっと	훌쩍	0
ぐちゅって	질척하고	0	//ここにぐちゅって入れて
くちゅっと	질척	0
ぐちゅりと	질척	0
くつくつと	쿡쿡	0
クッパリと	뻐끔	0
くっぱりと	뻐끔	0
ぐにゅっと	물컹	0
グニュリと	물컹	0
ぐにゅりと	물컹	0
くらっと	어지럽게	0
くりっと	동그랗게	0
グルリと	빙글	0
ぐるりと	빙글	0
くわっと	활짝	0	//くわっと瞳を見開き、
ごきゅっと	꿀꺽	0
こくっと	끄덕	0
ごくりと	꿀꺽	0
こくんと	끄덕	0
こつりと	딱	0
こつんと	딱	0
こてんこてんと	끄덕끄덕	0
ゴボリと	쿨렁	0
ごぼりと	쿨렁	0
こりっと	으득	0
ごりっと	으득	0
ころんと	데굴	0
ごろんと	벌렁	0
さくっと	살짝	0
サッサと	빨리	0
ざっぱんと	첨벙	0
さらっと	슬쩍	0
サンサンと	찬란히	0
シミジミと	절절히	0
しみじみと	절절히	0
シャキッと	산뜻하게	0
しゃきっと	산뜻하게	0
しゅんっと	슈읏	0
しゅんと	시무룩	0
じりっと	지릿	0
じろっと	힐끔	0
すうっと	스윽	0
ずきっと	욱신	0
ずきりと	욱신	0
ずどんと	쾅	0
ずぶって	즈붓하고	0	//ずぶって差し込んでぇえ……！
ずぶっと	즈붓	0
ずぼっと	푸욱	0
ずらぁっと	줄줄이	0
すらっと	술술	0
ずらっと	줄줄이	0
するっと	스륵	0
ぞくっと	오싹	0
ぞくんっと	오싹	0
ゾロリと	주렁주렁	0
ぞろりと	주렁주렁	0
ぞわっと	오싹	0
たゆんっと	출렁	0
たゆんと	출렁	0
タラリと	추욱	0
ダラリと	축	0
ちぃっと	조금	0
ちゃっちゃと	빨리	0
ちょこんと	툭	0
ちょろっと	찔끔	0
チロッと	살짝	0
ちろっと	살짝	0
ツツッと	쓰윽	0
つつっと	쓰윽	0
てれりと	수줍게	0
どーんと	두둥	0
ドキリと	덜컥	0
とろっと	질척	0
とろんと	몽롱	0
トロンと	몽롱하게	0
ドンドンと	점점	0
にこりと	생긋	0
ニタリと	히죽	0
ニヤリと	힐쭉	0
にょきっと	삐죽이	0
ぬめっと	미끌	0
ヌメリと	미끌	0
ぬるっと	미끌	0
ぱあっと	파앗	0
ぱぁっと	파앗	0	//シルフィーヌはぱぁっと顔をほころばせる。
はぁっと	하앗	0
パクッと	덥썩	0
ぱくっと	덥썩	0
ぱたんと	꽈당	0
ぱっくんと	덥썩	0
びくっと	움찔	0
ぴくっと	움찔	0
ビクリと	흠칫	0
ピクリと	흠칫	0
ぴくんと	움찔	0
ひくんと	흠칫	0
びくんと	흠칫	0
びしっと	딱	0
ピタリと	꼭	0
ぴちゃっと	피챳	0
ぴっちりと	딱	0
ぴっちりとした	착 밀착된	0	//ぴっちりとした肉唇。
ぴっちりとして	착 밀착되어	0
ぴとっと	딱	0
ヒヤリと	섬뜩	0
びゅくんっと	흠칫	0
びゅくんと	흠칫	0
ひょいっと	폴짝	0
ぴょこっと	깡총	0
ぴょこんと	깡총	0
びりっと	지릿	0
ビリリと	지르르	0
びりりと	지르르	0
ぶあっと	부왁	0
ぷいっと	휙	0
プクッと	볼록	0
ぷくっと	볼록	0
プツリと	뚝	0
ぷつりと	뚝	0
ぷつんと	툭	0
ぶぴゅっと	부퓻	0
ふふっと	후훗	0
ふらっと	훌쩍	0
ぷりっと	탱글	0
ぶるっと	부르릇	0
ブルリと	부르르	0
ぷるんと	말랑말랑	0
ぶるんと	부릉	0
ふわっと	둥실	0
ブワッと	부왁	0
ぶわっと	부왁	0
フワリと	살짝	0
ぺこっと	꾸벅	0
ぺたんと	풀썩	0
ぺちゃっと	페챳	0
ぺろっと	날름	0
べろんと	날름	0
ぽかーんと	머-엉	0
ぼけっと	멍하니	0
ぼこりと	볼록	0
ぼそっと	멀거니	0
ぽそりと	나지막히	0
ぼっと	멍하니	0
ポツンと	우두커니	0
ぽつんと	우두커니	0
ぽろっと	투욱	0
ほわっと	둥실	0
まざまざと	역력하게	0
マッタリと	느긋하게	0
むぎゅっと	물컹	0
むくっと	벌떡	0
むにゅっと	물컹	0
むにゅんと	물렁	0
むらっと	므흣	0
むんずと	꽉	0
ゆるりと	천천히	0
ヨシヨシと	좋아좋아	0
苛っと	울컥	0
負けじと	지지 않으려고	0
沸々と	부글부글	0	//ぶつぶつ
深々と	깊숙히	0
沁沁と	절절히	0
染染と	절절히	0
丸丸と	토실토실	0
活き活きと	생생하게	0
ひっそりと	고요하게	0
ヒッソリと	고요하게	0
きょとんと	멍청히	0
はらりと	사르르	0
ハラリと	사르르	0
ボケッと	멍하니	0	//ボケッとしてるから
ずしりと	묵직하게	0
ひっしと	필사적으로	0	//ひっしと抱きついた
のそりと	느릿하게	0
ぱしっと	퍽	0
冷やっと	오싹	0
ひやっと	오싹	0
しれっと	태연히	0	//しれっと答えたすみれは、針金らしき物を俺に見せてきた。
ぴくって	움찔	0
ぬぼーっと	멍하니	0
ぷにっと	말랑	0
ぷにーっと	말랑	0
ずばっと	푸욱	0
ずばーっと	푸욱	0
はつらつと	발랄하게	0
つつーっと	쓰-윽	0
そーっと	살짝	0
つるんと	주륵	0
からっと	활짝	0
からーっと	활짝	0	//明日も同じようにからっと晴れてくれるらしい。
きゅうぅって	꽈악	0
きゅうって	꽈악	0
きゅうっと	꽈악	0
ほのぼのと	따끈따끈	0
ツツーッと	쓰-윽	0
きゅっと	꽉	0
きゅーっと	꽉	0
きゅんきゅんって	큥큥하고	0
ぴくんっと	움찔	0
ぴくんって	움찔	0
ぷつんて	툭	0	//張り詰めた糸がぷつんて切れちゃいそうなの。
ぷつんって	툭	0
ちゃちゃっと	빨리	0
ざくっと	스윽[ざくっと]	0	//ざくっと行くか
ホイホイと	척척	0
じゃらっと	좌락	0
さんじゃらっと	조금	0
ずずずっと	즈즈즛	0
ずずっと	즈즛	0
びびっと	찌릿	0
ぱぱっと	파팟	0
こそっと	살며시	0
だらんと	축	0	//だらんとベッドの下へと降ろした。
どくんと	두근	0
ぷりんと	포동	0
ぽけーっと	멍하게	0
ぽけっと	멍하게	0
ぽやんと	멍하게	0
ぽやーんと	멍하게	0
ちょんと	슬쩍[ちょんと]	0
すっくと	우뚝	0
にへらっと	헤벌죽	0
にへらと	헤벌죽	0
ぷよんと	말랑	0
くたりと	축	0
たんたんと	담담히	0
ざらりと	가칠가칠	0
ぽいっと	휙	0
ぷしゅーって	푸슛	0
ぷしゅって	푸슛	0
一歩二歩と	한 걸음 두 걸음	0	//俺から一歩二歩と離れて振り返り、
じとっと	음습하게	0
じとーっと	음습하게	0
ころっと	홀랑	0	//ころっと忘れていた。
ちょこちょこっと	촐랑촐랑	0
うぐっと	우긋	0	//うぐっと言葉に詰まってしまう。序列はもうぐっと上がる。
ぶつりと	툭	0	//警告音もぶつりと途切れる。
ふんっと	흥	0	//俺を見下ろしたユカはふんっと鼻を鳴らす。
ぺこんと	꾸벅	0	//ぺこんとお辞儀する。
ぽーっと	멍하니	0
ぼーっと	멍하니	0
ぽっと	멍하니	0
ぷるんっと	탱글	0
うすっらと	희미하게	0	//원래 うっすらと 인데, 자주 나오는 오타라 입력.
ひょこっと	불쑥	0
じゅっと	바지직	0
ほけっと	멍하니	0
ぷくりと	봉긋	0
もぞりと	꿈지럭	0
ばたりと	툭	0


//▰ ABxB형 '부사 (번역어도 ABxB임)
アタフタ	허둥지둥∥t	0
アチアチ	후끈후끈∥t	0
あちあち	후끈후끈∥t	0
アチアチッ	후끈후끈∥t	0
アツアツ	후끈후끈∥t	0
あつあつ	후끈후끈∥t	0
アツアツッ	후끈후끈∥t	0
アムアム	얌얌∥t	0
あむあむ	얌얌∥t	0
アンアン	앙앙∥t	0
あんあん	앙앙∥t	0
イガイガ	거칠거칠∥t	0
いがいが	거칠거칠∥t	0
イジイジ	쭈뼛쭈뼛∥t	0
いじいじ	쭈뼛쭈뼛∥t	0
イチャイチャ	러브러브∥t	0
いちゃいちゃ	러브러브∥t	0
イボイボ	오돌오돌∥t	0
いぼいぼ	오돌오돌∥t	0
イライラ	안절부절∥t	0
いらいら	안절부절∥t	0
//ウィンウィン	윙윙∥t	0	//"win win"
うぃんうぃん	윙윙∥t	0
ウインウイン	윙윙∥t	0
ういんういん	윙윙∥t	0
//ウィンウィンッ	윙윙∥t	0	//"win win"
ウインウインッ	윙윙∥t	0
ウカウカ	엄벙덤벙∥t	0
うかうか	엄벙덤벙∥t	0
ウキウキ	울렁울렁∥t	0
うきうき	울렁울렁∥t	0
ウジウジ	머뭇머뭇∥t	0
うじうじ	머뭇머뭇∥t	0
ウズウズ	근질근질∥t	0
うずうず	근질근질∥t	0
ウダウダ	궁시렁궁시렁∥t	0
うだうだ	궁시렁궁시렁∥t	0
ウツラウツラ	꾸벅꾸벅∥t	0
ウニウニ	지끈지끈∥t	0
うにうに	지끈지끈∥t	0
ウネウネ	꾸불꾸불∥t	0
ウムウム	음음∥t	0
うむうむ	음음∥t	0
ウルウル	글썽글썽∥t	0
うるうる	글썽글썽∥t	0
ウロウロ	우왕좌왕∥t	0
ウロチョロ	얼쩡얼쩡∥t	0
うろちょろ	얼쩡얼쩡∥t	0
ウンウン	응응∥t	0
えーんえーん	엥엥∥t	0
おいでおいで	이리와 이리와∥t	0
おぎゃぁおぎゃぁ	응애응애∥t	0
おぎゃあおぎゃあ	응애응애∥t	0
オギャオギャ	응애응애∥t	0
おぎゃおぎゃ	응애응애∥t	0
オズオズ	흠칫흠칫∥t	0
オタオタ	허둥지둥∥t	0
おたおた	허둥지둥∥t	0
オドオド	흠칫흠칫∥t	0
おどおど	흠칫흠칫∥t	0
オロオロ	허둥지둥∥t	0
ガクガク	삐걱삐걱∥t	0
がくがく	삐걱삐걱∥t	0
ガクガクッ	삐걱삐걱∥t	0
ガクンガクン	덜컥덜컥∥t	0
がくんがくん	덜컥덜컥∥t	0
ガクンガクンッ	덜컥덜컥∥t	0
ガサガサ	부스럭부스럭∥t	0
がさがさ	부스럭부스럭∥t	0
ガサガサッ	부스럭부스럭∥t	0
カサコソ	바스락바스락∥t	0
ガサゴソ	부스럭부스럭∥t	0
がさごそ	부스럭부스럭∥t	0
ガサゴソッ	부스럭부스럭∥t	0
ガサバサ	부스럭부스럭∥t	0
がさばさ	부스럭부스럭∥t	0
ガサバサッ	부스럭부스럭∥t	0
ガシガシ	슥싹슥싹∥t	0
がしがし	슥싹슥싹∥t	0
カシャカシャ	찰칵찰칵∥t	0
かしゃかしゃ	찰칵찰칵∥t	0
カシャカシャッ	찰칵찰칵∥t	0
カシャッカシャッ	찰칵찰칵∥t	0
かしゃっかしゃっ	찰칵찰칵∥t	0
かすれがすれ	가랑가랑∥t	0
カタカタ	달각달각∥t	0
かたかた	달각달각∥t	0
ガタッガタッ	덜컹덜컹∥t	0
がたっがたっ	덜컹덜컹∥t	0
カチカチ	딱딱∥t	0
かちかち	딱딱∥t	0
ガチガチ	딱딱∥t	0	//(딱딱한 물체가 부딪치는 소리)
がちがち	딱딱∥t	0	//(딱딱한 물체가 부딪치는 소리)
ガチガチッ	딱딱∥t	0	//(딱딱한 물체가 부딪치는 소리)
ガチムチ	울끈불끈∥t	0
がちむち	울끈불끈∥t	0
ガチャガチャ	절컥절컥∥t	0
がちゃがちゃ	절컥절컥∥t	0
カチャカチャ	찰칵찰칵∥t	0
かちゃかちゃ	찰칵찰칵∥t	0
ガチャガチャッ	절컥절컥∥t	0
カチャカチャッ	찰칵찰칵∥t	0
カチャッカチャッ	찰칵찰칵∥t	0
かちゃっかちゃっ	찰칵찰칵∥t	0
ガツガツ	걸근걸근∥t	0
カツカツ	빠듯빠듯∥t	0
かつかつ	빠듯빠듯∥t	0
ガックンガックン	덜컥덜컥∥t	0
がっくんがっくん	덜컥덜컥∥t	0
ガックンガックンッ	덜컥덜컥∥t	0
カッチカチ	딱딱∥t	0
ガッチガチ	딱딱∥t	0
ガッチガッチ	딱딱∥t	0	//(딱딱한 물체가 부딪치는 소리)
がっちがっち	딱딱∥t	0	//(딱딱한 물체가 부딪치는 소리)
ガツンガツン	퍼억퍼억∥t	0
がつんがつん	퍼억퍼억∥t	0
ガツンガツンッ	퍼억퍼억∥t	0
ガバガバ	출렁출렁∥t	0
ガビガビ	푸석푸석∥t	0
がびがび	푸석푸석∥t	0
ガミガミ	군시렁 군시렁∥t	0
カラコロ	딸깍딸깍∥t	0
カラコロン	딸랑딸랑∥t	0
カランコロン	딸랑딸랑∥t	0
ガリガリ	으득으득∥t	0
がりがり	으득으득∥t	0
カリカリ	파삭파삭∥t	0
かりかり	파삭파삭∥t	0
キイキイ	키이키이∥t	0
キシキシ	삐걱삐걱∥t	0
きしきし	삐걱삐걱∥t	0
ギシギシ	삐걱삐걱∥t	0
ぎしぎし	삐걱삐걱∥t	0
ギシギシッ	삐걱삐걱∥t	0
ギスギス	깨깨∥t	0
ぎすぎす	깨깨∥t	0
ギタギタ	진득진득∥t	0
ぎたぎた	진득진득∥t	0
ギチギチ	삐걱삐걱∥t	0
キツキツ	바둥바둥∥t	0
きつきつ	바둥바둥∥t	0
ギッシギッシ	삐걱삐걱∥t	0
ぎっしぎっし	삐걱삐걱∥t	0
ギッタンギッタン	퍼벅퍼벅∥t	0
ぎったんぎったん	퍼벅퍼벅∥t	0
ギトギト	번들번들∥t	0
ぎとぎと	번들번들∥t	0
キビキビ	시원시원∥t	0
きびきび	시원시원∥t	0
キャァキャァ	꺄아꺄아∥t	0	//(놀랍고 무서워서 내는 소리. 장난치며 떠드는 소리)
きゃぁきゃぁ	꺄아꺄아∥t	0	//(놀랍고 무서워서 내는 소리. 장난치며 떠드는 소리)
キャアキャア	꺄아꺄아∥t	0	//(놀랍고 무서워서 내는 소리. 장난치며 떠드는 소리)
きゃあきゃあ	꺄아꺄아∥t	0	//(놀랍고 무서워서 내는 소리. 장난치며 떠드는 소리)
ギャァギャァ	꺄아꺄아∥t	0	//(놀랍고 무서워서 내는 소리. 장난치며 떠드는 소리)
ぎゃぁぎゃぁ	꺄아꺄아∥t	0	//(놀랍고 무서워서 내는 소리. 장난치며 떠드는 소리)
ギャアギャア	꺄아꺄아∥t	0	//(놀랍고 무서워서 내는 소리. 장난치며 떠드는 소리)
ぎゃあぎゃあ	꺄아꺄아∥t	0	//(놀랍고 무서워서 내는 소리. 장난치며 떠드는 소리)
キャピキャピ	상큼상큼∥t	0
きゃぴきゃぴ	상큼상큼∥t	0
ギャフン	갸흥∥t	0
ぎゃふん	갸흥∥t	0
キュウキュウ	큐우큐우∥t	0
きゅうきゅう	큐우큐우∥t	0
キュッキュッ	꼬옥꼬옥∥t	0
ギュッギュッ	꾹꾹∥t	0
ぎゅっぎゅっ	꾹꾹∥t	0
きゅっきゅっ	꼬옥꼬옥∥t	0
ギュンギュン	꾸욱꾸욱∥t	0
ぎゅんぎゅん	꾸욱꾸욱∥t	0
キョロキョロ	두리번두리번∥t	0
ギラギラ	번득번득∥t	0	//(놀랍고 무서워서 내는 소리. 장난치며 떠드는 소리)
ぎらぎら	번득번득∥t	0	//(놀랍고 무서워서 내는 소리. 장난치며 떠드는 소리)
キラキラッ	반짝반짝∥t	0
ギラギラッ	번득번득∥t	0	//(놀랍고 무서워서 내는 소리. 장난치며 떠드는 소리)
ギンギン	끙끙∥t	0
ぎんぎん	끙끙∥t	0
クイクイ	꾹꾹∥t	0
グイグイ	쭉쭉∥t	0
ぐいぐい	쭉쭉∥t	0
クイクイッ	꾹꾹∥t	0
クイックイッ	꾸욱꾸욱∥t	0
グイングイン	휘익휘익∥t	0
ぐいんぐいん	휘익휘익∥t	0
グウグウ	쿨쿨∥t	0
グサグサ	푸욱푸욱∥t	0
ぐさぐさ	푸욱푸욱∥t	0
グジグジ	투덜투덜∥t	0
ぐじぐじ	투덜투덜∥t	0
クシャクシャ	꾸깃꾸깃∥t	0
くしゃくしゃ	꾸깃꾸깃∥t	0
グシャグシャ	뭉글뭉글∥t	0
ぐしゃぐしゃ	뭉글뭉글∥t	0
グシュグシュ	주륵주륵∥t	0
ぐしゅぐしゅ	주륵주륵∥t	0
グジュグジュ	훌쩍훌쩍∥t	0
ぐじゅぐじゅ	훌쩍훌쩍∥t	0
グショグショ	흠뻑흠뻑∥t	0
ぐしょぐしょ	흠뻑흠뻑∥t	0
グズグズ	꾸물꾸물∥t	0
ぐずぐず	꾸물꾸물∥t	0
クスクスッ	키득키득∥t	0
グダグダ	구질구질∥t	0
ぐだぐだ	구질구질∥t	0
クタクタ	기진맥진∥t	0
グチグチ	궁시렁궁시렁∥t	0
ぐちぐち	궁시렁궁시렁∥t	0
クチクチ	질퍽질퍽∥t	0
くちくち	질퍽질퍽∥t	0
クチュックチュッ	질척질척∥t	0
クツクツ	쿡쿡∥t	0
くつくつ	쿡쿡∥t	0
ぐっちょぐちょ	질척질척∥t	0
グッポグッポ	굽포굽포∥t	0
ぐっぽぐっぽ	굽포굽포∥t	0
クドクド	주절주절∥t	0
くどくど	주절주절∥t	0
グナグナ	물컹물컹∥t	0
ぐなぐな	물컹물컹∥t	0
クナクナ	하늘하늘∥t	0
クニクニ	만지작만지작∥t	0
くにくに	만지작만지작∥t	0
グニグニ	슥슥∥t	0
ぐにぐに	슥슥∥t	0
クニクニッ	만지작만지작∥t	0
グニグニッ	슥슥∥t	0
ぐにゃぐにゃ	흐늘흐늘∥t	0
グニヤグニャ	흐늘흐늘∥t	0
グニュグニュ	말랑말랑∥t	0
ぐにゅぐにゅ	말랑말랑∥t	0
グニングニン	몰캉몰캉∥t	0
ぐにんぐにん	몰캉몰캉∥t	0
グニングニンッ	몰캉몰캉∥t	0
クネクネ	구불구불∥t	0
くねくね	구불구불∥t	0
グネグネ	구불구불∥t	0
ぐねぐね	구불구불∥t	0
クネクネッ	구불구불∥t	0
グネグネッ	구불구불∥t	0
クパクパ	움찔움찔∥t	0
くぱくぱ	움찔움찔∥t	0
グビグビ	꿀걱꿀걱∥t	0
グプグプ	부글부글∥t	0
ぐぷぐぷ	부글부글∥t	0
クヨクヨ	끙끙∥t	0
グラグラ	흔들흔들∥t	0
クリクリ	동글동글∥t	0
くりくり	동글동글∥t	0
グリグリ	동글동글∥t	0
ぐりぐり	동글동글∥t	0
クリクリッ	동글동글∥t	0
グリグリッ	동글동글∥t	0
グルングルン	빙글빙글∥t	0
ぐるんぐるん	빙글빙글∥t	0
グワングワン	구웅구웅∥t	0
ぐわんぐわん	구웅구웅∥t	0
グングン	부쩍부쩍∥t	0
ゲシゲシ	퍽퍽∥t	0
げしげし	퍽퍽∥t	0
ゲシゲシッ	퍽퍽∥t	0
ケタケタ	낄낄∥t	0
ケホケホ	콜록콜록∥t	0
けほけほ	콜록콜록∥t	0
ゲホゲホ	콜록콜록∥t	0
げほげほ	콜록콜록∥t	0
ケホケホッ	콜록콜록∥t	0
ゲホゲホッ	콜록콜록∥t	0
ケホンケホン	콜록콜록∥t	0
けほんけほん	콜록콜록∥t	0
ゲホンゲホン	콜록콜록∥t	0
げほんげほん	콜록콜록∥t	0
ケホンケホンッ	콜록콜록∥t	0
ゲホンゲホンッ	콜록콜록∥t	0
ケロケロ	개굴개굴∥t	0
けろけろ	개굴개굴∥t	0
ゲロゲロ	개굴개굴∥t	0
げろげろ	개굴개굴∥t	0
ケロケロッ	개굴개굴∥t	0
ゲロゲロッ	개굴개굴∥t	0
ゴウゴウ	시끌시끌∥t	0
ごうごう	시끌시끌∥t	0
ゴキゴキ	뽀각뽀각∥t	0
ごきごき	뽀각뽀각∥t	0
コキコキ	우득우득∥t	0
こきこき	우득우득∥t	0
ゴキュゴキュ	꿀꺽꿀꺽∥t	0
ごきゅごきゅ	꿀꺽꿀꺽∥t	0
コクコク	끄덕끄덕∥t	0
こくこく	끄덕끄덕∥t	0
コクコクッ	끄덕끄덕∥t	0
コシコシ	슥슥∥t	0
こしこし	슥슥∥t	0
ゴシゴシ	쓱쓱∥t	0
ごしごし	쓱쓱∥t	0
ゴシャゴシャ	뒤죽박죽∥t	0
ごしゃごしゃ	뒤죽박죽∥t	0
ゴソゴソ	바스락바스락∥t	0
コソコソ	소근소근∥t	0
ゴチャゴチャ	뒤죽박죽∥t	0
コチョコチョ	간질간질∥t	0
こちょこちょ	간질간질∥t	0
ゴツゴツ	울퉁불퉁∥t	0
コツコツ	톡톡∥t	0
こつこつ	톡톡∥t	0
ゴッツンゴッツン	터억터억∥t	0
ごっつんごっつん	터억터억∥t	0
ゴツンゴツン	터억터억∥t	0
ごつんごつん	터억터억∥t	0
コテコテ	덕지덕지∥t	0
こてこて	덕지덕지∥t	0
コトコト	달각달닥∥t	0
ことこと	달각달닥∥t	0
ゴニョゴニョ	소근소근∥t	0
ごにょごにょ	소근소근∥t	0
コポコポ	보글보글∥t	0
こぽこぽ	보글보글∥t	0
コホコホ	콜록콜록∥t	0
こほこほ	콜록콜록∥t	0
ゴホゴホ	쿨럭쿨럭∥t	0
ごほごほ	쿨럭쿨럭∥t	0
ゴボゴボ	쿨렁쿨렁∥t	0
ごぼごぼ	쿨렁쿨렁∥t	0
コホコホッ	콜록콜록∥t	0
ゴホゴホッ	쿨럭쿨럭∥t	0
ゴボゴボッ	쿨렁쿨렁∥t	0
コホッコホッ	콜록콜록∥t	0
こほっこほっ	콜록콜록∥t	0
ゴホッゴホッ	쿨럭쿨럭∥t	0
ごほっごほっ	쿨럭쿨럭∥t	0
コホンコホン	콜록콜록∥t	0
こほんこほん	콜록콜록∥t	0
ゴホンゴホン	쿨럭쿨럭∥t	0
ごほんごほん	쿨럭쿨럭∥t	0
コホンコホンッ	콜록콜록∥t	0
ゴホンゴホンッ	쿨럭쿨럭∥t	0
ゴリゴリ	빠득빠득∥t	0
ごりごり	빠득빠득∥t	0
コリコリ	오돌오돌∥t	0
こりこり	오돌오돌∥t	0
コリゴリ	지긋지긋∥t	0
こりごり	지긋지긋∥t	0
ゴロゴロ	뒹굴뒹굴∥t	0
ごろごろ	뒹굴뒹굴∥t	0
ゴロゴロン	뒹굴뒹굴∥t	0
ごろごろん	뒹굴뒹굴∥t	0
ゴロンゴロン	뒹굴뒹굴∥t	0
ごろんごろん	뒹굴뒹굴∥t	0
ゴワゴワ	뻣뻣∥t	0
ごわごわ	뻣뻣∥t	0
コワコワ	오싹오싹∥t	0
こわこわ	오싹오싹∥t	0
ゴンゴン	댕댕∥t	0
ごんごん	댕댕∥t	0
コンコン	콩콩∥t	0
こんこん	콩콩∥t	0
コンコンコン	콩콩콩∥t	0
こんこんこん	콩콩콩∥t	0
コンコンッ	콩콩∥t	0
サクサク	사각사각∥t	0
さくさく	사각사각∥t	0
ザクザク	서걱서걱∥t	0
ざくざく	서걱서걱∥t	0
ザクザクッ	서걱서걱∥t	0
ザックザク	서걱서걱∥t	0
ザックザクッ	서걱서걱∥t	0
ざっくざっく	서걱서걱∥t	0
ザッザッ	삭삭∥t	0
ざっざっ	삭삭∥t	0
ザッパンザッパン	첨벙첨벙∥t	0
ざっぱんざっぱん	첨벙첨벙∥t	0
サバサバ	시원시원∥t	0
さばさば	시원시원∥t	0
さらさらさら	줄줄줄∥t	0
サワサワ	산들산들∥t	0
サワサワサワ	산들산들산들∥t	0
さわさわ	산들산들∥t	0
さわさわさわ	산들산들산들∥t	0
ザワザワ	술렁술렁∥t	0
ざわざわ	술렁술렁∥t	0
ジクジク	질척질척∥t	0
シクシク	훌쩍훌쩍∥t	0
シコシコ	쫄깃쫄깃∥t	0
シズシズ	조용조용∥t	0
ジタバタ	바동바동∥t	0
ジトジト	눅진눅진∥t	0
じとじと	눅진눅진∥t	0
ジメジメ	눅진눅진∥t	0
じめじめ	눅진눅진∥t	0
シャアシャア	솨아솨아∥t	0
しゃあしゃあ	솨아솨아∥t	0
シャイシャイ	샤이샤이∥t	0
シャカシャカ	사각사각∥t	0
しゃかしゃか	사각사각∥t	0
シャキシャキ	척척∥t	0
ジャラジャラ	짤랑짤랑∥t	0
ジャリジャリ	자그락자그락∥t	0
じゃりじゃり	자그락자그락∥t	0
ジャンジャン	척척∥t	0
ジュージュー	지글지글∥t	0
ジュクジュク	질퍽질퍽∥t	0
じゅくじゅく	질퍽질퍽∥t	0
ジュクジュクッ	질퍽질퍽∥t	0
ジュックジュック	질퍽질퍽∥t	0
じゅっくじゅっく	질퍽질퍽∥t	0
シュッシュッ	슉슉∥t	0
しゅっしゅっ	슉슉∥t	0
ジュップジュップ	질퍽질퍽∥t	0
じゅっぷじゅっぷ	질퍽질퍽∥t	0
ジュブジュブ	쥬웁쥬웁∥t	0
じゅぶじゅぶ	쥬웁쥬웁∥t	0
ジュプジュプ	질퍽질퍽∥t	0
じゅぷじゅぷ	질퍽질퍽∥t	0
ジュプジュプッ	질퍽질퍽∥t	0
ジュポジュポ	쭈웁쭈웁∥t	0
じゅぽじゅぽ	쭈웁쭈웁∥t	0
ジュルジュル	줄줄∥t	0
じゅるじゅる	줄줄∥t	0
ジョキジョキ	사각사각∥t	0
じょきじょき	사각사각∥t	0
ショボショボ	보슬보슬∥t	0
ジョボジョボ	졸졸∥t	0
じょぼじょぼ	졸졸∥t	0
ジョリジョリ	까끌까끌∥t	0
じょりじょり	까끌까끌∥t	0
ジリジリ	바작바작∥t	0
じりじり	바작바작∥t	0
シワクチャ	쪼글쪼글∥t	0
しわくちゃ	쪼글쪼글∥t	0
ジワジワ	서서히	0
シワシワ	쭈글쭈글∥t	0
しわしわ	쭈글쭈글∥t	0
ジワジワと	서서히	0
ジワリジワリ	차츰차츰∥t	0
ジンジン	지릿지릿∥t	0
じんじん	지릿지릿∥t	0
ズイズイ	즈욱즈욱∥t	0
ずいずい	즈욱즈욱∥t	0
スゥスゥ	스으스으∥t	0
すぅすぅ	스으스으∥t	0
スウスウ	스으스으∥t	0
すうすう	스으스으∥t	0
スースー	스으스으∥t	0
すーすー	스으스으∥t	0
スーズー	스으즈으∥t	0
ズカズカ	성큼성큼∥t	0
ずかずか	성큼성큼∥t	0
スカスカ	척척∥t	0
すかすか	척척∥t	0
ズカズカッ	성큼성큼∥t	0
ズギュンズギュン	즈귱즈귱∥t	0
ずぎゅんずぎゅん	즈귱즈귱∥t	0
ズキンズキン	욱신욱신∥t	0
ずきんずきん	욱신욱신∥t	0
スクスク	쑥쑥∥t	0
すくすく	쑥쑥∥t	0
ズクズク	질퍽질퍽∥t	0
ずくずく	질퍽질퍽∥t	0
スケスケ	보일듯 말듯∥t	0
すけすけ	보일듯 말듯∥t	0
ズケズケ	성큼성큼∥t	0
ずけずけ	성큼성큼∥t	0
スゴスゴ	터벅터벅∥t	0
すごすご	터벅터벅∥t	0
ズジュズジュ	즈쥬즈쥬∥t	0
ずじゅずじゅ	즈쥬즈쥬∥t	0
ズタズタ	갈기갈기∥t	1
スタスタ	총총∥t	0
すたすた	총총∥t	0
ズタボロ	너덜너덜∥t	0
ずたぼろ	너덜너덜∥t	0
ズッコンバッコン	붕가붕가∥t	0
ずっこんばっこん	붕가붕가∥t	0
ズッボズッボ	쑤컹쑤컹∥t	0
ずっぼずっぼ	쑤컹쑤컹∥t	0
ズッポズッポ	쑤컹쑤컹∥t	0
ずっぽずっぽ	쑤컹쑤컹∥t	0
スバスバ	뻑뻑∥t	0
すばすば	뻑뻑∥t	0
ズバズバ	성큼성큼∥t	0
ずばずば	성큼성큼∥t	0
スブズブ	푸욱푸욱∥t	0
すぶずぶ	푸욱푸욱∥t	0
ズブズブ	푸욱푸욱∥t	0
ずぶずぶ	푸욱푸욱∥t	0
ズブズブッ	푸욱푸욱∥t	0
ズボズボ	쑤컹쑤컹∥t	0
ずぼずぼ	쑤컹쑤컹∥t	0
ズポズポ	쑤컹쑤컹∥t	0
ずぽずぽ	쑤컹쑤컹∥t	0
ズボズボッ	쑤컹쑤컹∥t	0
ズポズポッ	쑤컹쑤컹∥t	0
ズボッズボッ	쑤컹쑤컹∥t	0
ずぼっずぼっ	쑤컹쑤컹∥t	0
ズポッズポッ	쑤컹쑤컹∥t	0
ずぽっずぽっ	쑤컹쑤컹∥t	0
スヤスヤ	새근새근∥t	0
スラスラ	술술∥t	0
スリスリ	부비부비∥t	0
すりすり	부비부비∥t	0
ズリズリ	주륵주륵∥t	0
ずりずり	주륵주륵∥t	0
ズリュズリュ	즈릅즈릅∥t	0
ずりゅずりゅ	즈릅즈릅∥t	0
スルスル	술술∥t	0
スルスルッ	술술∥t	0
スレスレ	아슬아슬∥t	0
すれすれ	아슬아슬∥t	0
ズンズン	부쩍부쩍∥t	0
ずんずん	부쩍부쩍∥t	0
スンスン	슝슝∥t	0
すんすん	슝슝∥t	0
スンッスンッ	슝슝∥t	0
ゾクゾク	오슬오슬∥t	0
ぞくぞく	오슬오슬∥t	0
ゾクゾクッ	오슬오슬∥t	0
ゾリゾリ	스윽스윽∥t	0
ぞりぞり	스윽스윽∥t	0
ソロソロ	슬슬∥t	0
そろそろ	슬슬∥t	0
ゾロゾロ	줄줄∥t	0
ぞろぞろ	줄줄∥t	0
ソロソロッ	슬슬∥t	0
ソロリソロリ	슬금슬금∥t	0
そろりそろり	슬금슬금∥t	0
ソワソワ	안절부절∥t	0
ゾワゾワ	움찔움찔∥t	0
ぞわぞわ	움찔움찔∥t	0
タジタジ	비틀비틀∥t	0
タトタト	토닥토닥∥t	0
たとたと	토닥토닥∥t	0
ダブダブ	출렁출렁∥t	0
だぶだぶ	출렁출렁∥t	0
タユタユ	찰랑찰랑∥t	0
たゆたゆ	찰랑찰랑∥t	0
タラタラ	주룩주룩∥t	0
たらたら	주룩주룩∥t	0
ダラダラ	질질∥t	0
だらだら	질질∥t	0
チカチカ	반짝반짝∥t	0
チクタク	똑딱똑딱∥t	0
ちくたく	똑딱똑딱∥t	0
ちくはぐ	뒤죽박죽∥t	0
チグハグ	뒤죽박죽∥t	0
チッチッ	칫칫∥t	0
チビリチビリ	찔끔찔끔∥t	0
ちびりちびり	찔끔찔끔∥t	0
チマチマ	조촐조촐∥t	0
ちまちま	조촐조촐∥t	0
ちゃきちゃき	착착∥t	0
チャキチャキ	챠키챠키∥t	0
チャクチャク	착착∥t	0
ちゃくちゃく	착착∥t	0
チャプチャプ	첨벙첨벙∥t	0
ちゃぷちゃぷ	첨벙첨벙∥t	0
チャプチャプッ	첨벙첨벙∥t	0
チャプンチャプン	첨벙첨벙∥t	0
ちゃぷんちゃぷん	첨벙첨벙∥t	0
チャプンチャプンッ	첨벙첨벙∥t	0
チヤホヤ	오냐오냐∥t	0
ちやほや	오냐오냐∥t	0
チャラチャラ	짤랑짤랑∥t	0
チュクチュク	따끔따끔∥t	0
ちゅくちゅく	따끔따끔∥t	0
チュチュ	츄츄∥t	0
ちゅちゅ	츄츄∥t	0
チュッチュッ	츗츗∥t	0
ちゅっちゅっ	츗츗∥t	0
ぢゅぷぢゅぷ	쥬브쥬브∥t	0
チュルチュル	츄룹츄룹∥t	0
ちゅるちゅる	츄룹츄룹∥t	0
チョイチョイ	살짝살짝∥t	0
ちょいちょい	살짝살짝∥t	0
チョキチョキ	싹둑싹둑∥t	0
ちょきちょき	싹둑싹둑∥t	0
チョコチョコ	총총∥t	0
チョコマカ	촐랑촐랑∥t	0
ちょこまか	촐랑촐랑∥t	0
チョメチョメ	XX∥t	0
ちょめちょめ	XX∥t	0
チョロチョロ	졸졸∥t	0
チラチラ	힐끔힐끔∥t	0
ちらちら	힐끔힐끔∥t	0
チラホラ	드문드문∥t	0
ちらほら	드문드문∥t	0
チリチリ	오글오글∥t	0
チロチロ	졸졸∥t	0
ちろちろ	졸졸∥t	0
チンタラ	우물쭈물∥t	0
ちんたら	우물쭈물∥t	0
チンプンカン	횡설수설∥t	0
ちんぷんかん	횡설수설∥t	0
チンプンカンプン	횡설수설∥t	0
ちんぷんかんぷん	횡설수설∥t	0
ツイツイ	무심코∥t	0
ついつい	무심코∥t	0
ツイツイッ	무심코∥t	0
ツカツカ	성큼성큼∥t	0
ツケツケ	성큼성큼∥t	0
ツベコベ	이러쿵저러쿵∥t	0
ツベコベッ	이러쿵저러쿵∥t	0
ツヤツヤ	반질반질∥t	0
ツンツン	츤츤∥t	0
つんつん	츤츤∥t	0
テカテカ	반질반질∥t	0
てかてか	반질반질∥t	0
テカテカッ	반질반질∥t	0
テキパキ	척척∥t	0
テクテク	터벅터벅∥t	0
テッカテッカ	반질반질∥t	0
てっかてっか	반질반질∥t	0
でへでへ	데헤데헤∥t	0
テラテラ	번들번들∥t	0
てらてら	번들번들∥t	0
デレデレ	데레데레∥t	0
でれでれ	데레데레∥t	0
ドギマギ	갈팡질팡∥t	0
どぎまぎ	갈팡질팡∥t	0
トキメキ	두근두근∥t	0
トギレトギレ	띄엄띄엄∥t	0
とぎれとぎれ	띄엄띄엄∥t	0
トクトク	쿨렁쿨렁∥t	0
とくとく	쿨렁쿨렁∥t	0
ドクドク	쿨렁쿨렁∥t	0
どくどく	쿨렁쿨렁∥t	0	//**どくどくしい
トクトクッ	쿨렁쿨렁∥t	0
ドクドクッ	쿨렁쿨렁∥t	0
ドサドサ	우르르∥t	0
どさどさ	우르르∥t	0
ドシドシ	척척∥t	0
どしどし	척척∥t	0
ドシドシッ	척척∥t	0
ドスドス	무시무시∥t	0
どすどす	무시무시∥t	0
ドタドタ	쿵쿵∥t	0
どたどた	쿵쿵∥t	0
トタトタ	타박타박∥t	0
とたとた	타박타박∥t	0
トタトタッ	타박타박∥t	0
ドタバタ	우당탕∥t	0
トテトテ	타박타박∥t	0
とてとて	타박타박∥t	0
トテトテッ	타박타박∥t	0
ドバドバ	줄줄∥t	0
どばどば	줄줄∥t	0
どびゅどびゅ	도뷰도뷰∥t	0
ドブドブ	질퍽질퍽∥t	0
どぶどぶ	질퍽질퍽∥t	0
トボトボ	터벅터벅∥t	0
ドロッドロ	질척질척∥t	0
トロトロ	녹진녹진∥t	0
とろとろ	녹진녹진∥t	0
ドロドロ	질척질척∥t	0
トロトロッ	녹진녹진∥t	0
ドロドロッ	질척질척∥t	0
ナゴナゴ	재잘재잘∥t	0
なごなご	재잘재잘∥t	0
ナデナデ	스윽스윽∥t	0
なでなで	스윽스윽∥t	0
ナヨナヨ	나긋나긋∥t	0
ニアニア	빙긋빙긋∥t	0
ニギニギ	조물조물∥t	0
にぎにぎ	조물조물∥t	0
ニタニタ	히죽히죽∥t	0
ニチャニチャ	끈적끈적∥t	0
にちゃにちゃ	끈적끈적∥t	0
ニチュニチュ	끈적끈적∥t	0
にちゅにちゅ	끈적끈적∥t	0
ニヤニヤ	히죽히죽∥t	0
にやにや	히죽히죽∥t	0
ヌクヌク	따끈따끈∥t	0
ぬくぬく	따끈따끈∥t	0
ヌチャヌチャ	질척질척∥t	0
ぬちゃぬちゃ	질척질척∥t	0
ヌチュヌチュ	질퍽질퍽∥t	0
ぬちゅぬちゅ	질퍽질퍽∥t	0
ヌチュヌチュッ	질퍽질퍽∥t	0
ヌチョヌチョ	질퍽질퍽∥t	0
ぬちょぬちょ	질퍽질퍽∥t	0
ヌチョヌチョッ	질퍽질퍽∥t	0
ヌッチュヌッチュ	질퍽질퍽∥t	0
ぬっちゅぬっちゅ	질퍽질퍽∥t	0
ヌッチュヌッチュッ	질퍽질퍽∥t	0
ヌプッヌプッ	철퍽철퍽∥t	0
ぬぷっぬぷっ	철퍽철퍽∥t	0
ヌプヌプ	철퍽철퍽∥t	0
ぬぷぬぷ	철퍽철퍽∥t	0
ヌプヌプッ	철퍽철퍽∥t	0
ヌメヌメ	미끌미끌∥t	0
ぬめぬめ	미끌미끌∥t	0
ヌラヌラ	끈적끈적∥t	0
ぬらりくらり	뺀들뺀들∥t	0
ヌルヌル	미끈미끈∥t	0
ヌレヌレ	반들반들∥t	0
ぬれぬれ	반들반들∥t	0
ネチネチ	치근치근∥t	0
ネチャッネチャッ	꿀쩍꿀쩍∥t	0
ねちゃっねちゃっ	꿀쩍꿀쩍∥t	0
ネチャネチャ	꿀쩍꿀쩍∥t	0
ねちゃねちゃ	꿀쩍꿀쩍∥t	0
ネチャネチャッ	꿀쩍꿀쩍∥t	0
ネチョネチョ	끈적끈적∥t	0
ねちょねちょ	끈적끈적∥t	0
ネトネト	끈적끈적∥t	0
ねとねと	끈적끈적∥t	0
ネトネトッ	끈적끈적∥t	0
ネバネバ	끈적끈적∥t	0
ねばねば	끈적끈적∥t	0
ネバネバッ	끈적끈적∥t	0
ノコノコ	어슬렁어슬렁∥t	0
ノシノシ	뚜벅뚜벅∥t	0
のしのし	뚜벅뚜벅∥t	0
ノソノソ	느릿느릿∥t	0
のそのそ	느릿느릿∥t	0
ノソリノソリ	느릿느릿∥t	0
のそりのそり	느릿느릿∥t	0
ノッシノッシ	뚜벅뚜벅∥t	0
のっしのっし	뚜벅뚜벅∥t	0
のらりくらり	뺀들뺀들∥t	0
ノリノリ	룰루랄라∥t	0
のりのり	룰루랄라∥t	0
ノロノロ	꾸물꾸물∥t	0
のろのろ	꾸물꾸물∥t	0
はぁはぁ	하아하아∥t	0
はあはあ	하아하아∥t	0
バインバイン	빵빵∥t	0
ばいんばいん	빵빵∥t	0
パカパカ	뚜그닥뚜그닥∥t	0
ぱかぱか	뚜그닥뚜그닥∥t	0
ハキハキ	또릿또릿∥t	0
はきはき	또릿또릿∥t	0
バキバキ	빠직빠직∥t	0
ばきばき	빠직빠직∥t	0
パキパキ	우득우득∥t	0
ぱきぱき	우득우득∥t	0
パクパク	빠끔빠끔∥t	0
ハグハグ	우걱우걱∥t	0
はぐはぐ	우걱우걱∥t	0
パクパクッ	빠끔빠끔∥t	0
バサバサ	써걱써걱∥t	0
ばさばさ	써걱써걱∥t	0
ばさばさばさ	써걱써걱써걱∥t	0
パサパサ	푸석푸석∥t	0
ぱさぱさ	푸석푸석∥t	0
バサバサッ	써걱써걱∥t	0
バシッバシッ	바식바식∥t	0
ばしっばしっ	바식바식∥t	0
バシバシ	바식바식∥t	0
ばしばし	바식바식∥t	0
パシパシ	팍팍∥t	0
ぱしぱし	팍팍∥t	0
バシバシッ	바식바식∥t	0
バシャバシャ	철퍽철퍽∥t	0
ばしゃばしゃ	철퍽철퍽∥t	0
パタパタ	탁탁∥t	0
ぱたぱた	탁탁∥t	0
バタバタ	파닥파닥∥t	0
ばたばた	파닥파닥∥t	0
バタバタッ	파닥파닥∥t	0
パチパチ	짝짝∥t	0
ぱちぱち	짝짝∥t	0
バチバチ	파식파식∥t	0
ばちばち	파식파식∥t	0
バッサバッサ	써걱써걱∥t	0
ばっさばっさ	써걱써걱∥t	0
バッタバッタ	파닥파닥∥t	0
ばったばった	파닥파닥∥t	0
ハネハネ	쭈삣쭈삣∥t	0
はねはね	쭈삣쭈삣∥t	0
ハムハム	냠냠∥t	0
はむはむ	냠냠∥t	0
ハラハラ	하늘하늘∥t	0
はらはら	하늘하늘∥t	0
パラパラ	후득후득∥t	0
ぱらぱら	후득후득∥t	0
バリバリ	바득바득∥t	0	//バリバリッと音が聞こえたような錯覚に陥るほどだった、令嬢の内部は固く閉ざされて私の侵入を拒んだが、私は圧倒的な力でそれを跳ね除けた。
ばりばり	바득바득∥t	0	//バリバリッと音が聞こえたような錯覚に陥るほどだった、令嬢の内部は固く閉ざされて私の侵入を拒んだが、私は圧倒的な力でそれを跳ね除けた。
パリパリ	파삭파삭∥t	0
バリバリッ	바득바득∥t	0	//バリバリッと音が聞こえたような錯覚に陥るほどだった、令嬢の内部は固く閉ざされて私の侵入を拒んだが、私は圧倒的な力でそれを跳ね除けた。
バンバン	팡팡∥t	0
ばんばん	팡팡∥t	0
パンパン	팡팡∥t	0
ぱんぱん	팡팡∥t	0
バンバンッ	팡팡∥t	0
パンパンッ	팡팡∥t	0
ビカビカ	반짝반짝∥t	0
びかびか	반짝반짝∥t	0
ピカピカ	번쩍번쩍∥t	0
ぴかぴか	번쩍번쩍∥t	0
ピカピカッ	번쩍번쩍∥t	0
ビキビキ	꿈틀꿈틀∥t	0
びきびき	꿈틀꿈틀∥t	0
ピキピキ	빠직빠직∥t	0
ぴきぴき	빠직빠직∥t	0
ピクッピクッ	쫑긋쫑긋∥t	0
ヒクッヒクッ	흠칫흠칫∥t	0
ピクピク	쫑긋쫑긋∥t	0
ぴくぴく	쫑긋쫑긋∥t	0
ヒクヒク	흠칫흠칫∥t	0
ひくひく	흠칫흠칫∥t	0
ピクピクッ	쫑긋쫑긋∥t	0
ヒクヒクッ	흠칫흠칫∥t	0
ヒクヒクン	흠칫흠칫∥t	0
ひくひくん	흠칫흠칫∥t	0
ヒクンヒクン	흠칫흠칫∥t	0
ピコピコ	삑삑∥t	0
ぴこぴこ	삑삑∥t	0
ヒシヒシ	오싹오싹∥t	0
ひしひし	오싹오싹∥t	0
ビシビシ	철썩철썩∥t	0
びしびし	철썩철썩∥t	0
ビシャビシャ	주륵주륵∥t	0
びしゃびしゃ	주륵주륵∥t	0
ビシャビシャッ	주륵주륵∥t	0
ビショビショ	주륵주륵∥t	0
びしょびしょ	주륵주륵∥t	0
ビジョビジョ	흠뻑흠뻑∥t	0
びじょびじょ	흠뻑흠뻑∥t	0
ビショビショッ	주륵주륵∥t	0
ビタビタ	질척질척∥t	0
びたびた	질척질척∥t	0
ヒタヒタ	찰싹찰싹∥t	0
ひたひた	찰싹찰싹∥t	0
ピチピチ	팔딱팔딱∥t	0
ぴちぴち	팔딱팔딱∥t	0
ビチビチ	후드득후드득∥t	0
びちびち	후드득후드득∥t	0
ビチビチッ	후드득후드득∥t	0
ビチャビチャ	철벅철벅∥t	0
びちゃびちゃ	철벅철벅∥t	0
ビチョビチョ	질척질척∥t	0
びちょびちょ	질척질척∥t	0
ピッカピッカ	번쩍번쩍∥t	0
ぴっかぴっか	번쩍번쩍∥t	0
ピッピッ	픽픽∥t	0
ぴっぴっ	픽픽∥t	0
ヒヤヒヤ	조마조마∥t	0
ビュクビュク	뷰크뷰크∥t	0
びゅくびゅく	뷰크뷰크∥t	0
ヒョウヒョウ	휘잉휘잉∥t	0
ひょうひょう	휘잉휘잉∥t	0
ヒョコヒョコ	깡총깡총∥t	0
ひょこひょこ	깡총깡총∥t	0
ピョコピョコ	폴짝폴짝∥t	0
ぴょこぴょこ	폴짝폴짝∥t	0
ヒョロヒョロ	비실비실∥t	0
ひょろひょろ	비실비실∥t	0
ピョンピョン	피용피용∥t	0
ぴょんぴょん	피용피용∥t	0
ビラビラ	펄럭펄럭∥t	0
びらびら	펄럭펄럭∥t	0
ピラピラ	펄럭펄럭∥t	0
ピリピリ	따끔따끔∥t	0
ぴりぴり	따끔따끔∥t	0
ビリビリ	찌릿찌릿∥t	0
びりびり	찌릿찌릿∥t	0
ピリピリッ	따끔따끔∥t	0
ビンビン	펄떡펄떡∥t	0
びんびん	펄떡펄떡∥t	0
ピンピン	펄떡펄떡∥t	0
ぴんぴん	펄떡펄떡∥t	0
ビンビンッ	펄떡펄떡∥t	0
ピンピンッ	펄떡펄떡∥t	0
フガフガ	웅얼웅얼∥t	0
ふがふが	웅얼웅얼∥t	0
ブカブカ	헐렁헐렁∥t	0
フキフキ	쓱싹쓱싹∥t	0
ふきふき	쓱싹쓱싹∥t	0
フギャフギャ	후갸후갸∥t	0
ふぎゃふぎゃ	후갸후갸∥t	0
ブシュッブシュッ	부슛부슛∥t	0
ぶしゅっぶしゅっ	부슛부슛∥t	0
プチプチ	뽁뽁∥t	0
ぷちぷち	뽁뽁∥t	0
ブチブチ	투덜투덜∥t	0
ぶちぶち	투덜투덜∥t	0
ブチブチッ	투덜투덜∥t	0
ブツクサ	투덜투덜∥t	0
ぶつくさ	투덜투덜∥t	0
フツフツ	부글부글∥t	0
プツプツ	톡톡∥t	0
ぷつぷつ	톡톡∥t	0
ブツブツ	투덜투덜∥t	0
ぶつぶつ	투덜투덜∥t	0
ブツブツッ	투덜투덜∥t	0
フニフニ	말랑말랑∥t	0
ふにふに	말랑말랑∥t	0
プニプニ	말랑말랑∥t	0
ぷにぷに	말랑말랑∥t	0
フニフニッ	말랑말랑∥t	0
プニプニッ	말랑말랑∥t	0
フニャフニャ	흐물흐물∥t	0
ふにゃふにゃ	흐물흐물∥t	0
フニャフニャッ	흐물흐물∥t	0
フニュフニュ	말랑말랑∥t	0
ふにゅふにゅ	말랑말랑∥t	0
フニンフニン	말랑말랑∥t	0
ふにんふにん	말랑말랑∥t	0
プニンプニン	말랑말랑∥t	0
ぷにんぷにん	말랑말랑∥t	0
フニンフニンッ	말랑말랑∥t	0
プニンプニンッ	말랑말랑∥t	0
フムフム	흠흠∥t	0
ふむふむ	흠흠∥t	0
フヨフヨ	푹신푹신∥t	0
ふよふよ	푹신푹신∥t	0
プラプラ	어슬렁어슬렁∥t	0
ぷらぷら	어슬렁어슬렁∥t	0
ふらりふらり	흔들흔들∥t	0
ブランブラン	덜렁덜렁∥t	0
ぶらんぶらん	덜렁덜렁∥t	0
フリフリ	살랑살랑∥t	0
ふりふり	살랑살랑∥t	0
ブリブリ	탱탱∥t	0
ぶりぶり	탱탱∥t	0
プリプリ	탱탱∥t	0
ぷりぷり	탱탱∥t	0
プリプリッ	탱탱∥t	0
プリンプリン	포동포동∥t	0
ぷりんぷりん	포동포동∥t	0
ブルッブルッ	부들부들∥t	0
プルプル	부들부들∥t	0
ぷるぷる	부들부들∥t	0
フルフル	흔들흔들∥t	0
ふるふる	흔들흔들∥t	0
プルプルッ	부들부들∥t	0
フルフルッ	흔들흔들∥t	0
ブルンブルン	부릉부릉∥t	0
ぶるんぶるん	부릉부릉∥t	0
プルンプルン	포동포동∥t	0
ぷるんぷるん	포동포동∥t	0
プルンプルンッ	포동포동∥t	0
フワフワ	둥실둥실∥t	0
ブンブン	붕붕∥t	0
ぶんぶん	붕붕∥t	0	//首をブンブンと振った。
フンフン	흥흥∥t	0
ブンブンッ	붕붕∥t	0
ヘコヘコ	굽실굽실∥t	0
へこへこ	굽실굽실∥t	0
ベコベコ	꼬르륵꼬르륵∥t	0
べこべこ	꼬르륵꼬르륵∥t	0
ペコペコ	꾸벅꾸벅∥t	0
ぺこぺこ	꾸벅꾸벅∥t	0
ペシペシ	짝짝∥t	0
ぺしぺし	짝짝∥t	0
ベシベシ	파밧파밧∥t	0
べしべし	파밧파밧∥t	0
ベタベタ	끈적끈적∥t	0
べたべた	끈적끈적∥t	0
ペタペタ	철썩철썩∥t	0
ぺたぺた	철썩철썩∥t	0
ベタベタッ	끈적끈적∥t	0
ペチペチ	찰싹찰싹∥t	0
ぺちぺち	찰싹찰싹∥t	0
ペチャペチャ	재잘재잘∥t	0
ぺちゃぺちゃ	재잘재잘∥t	0
ベチャベチャ	질철질척∥t	0
べちゃべちゃ	질철질척∥t	0
ベチョベチョ	들썩들썩∥t	0
べちょべちょ	들썩들썩∥t	0
ベッタベッタ	끈적끈적∥t	0
べったべった	끈적끈적∥t	0
ヘトヘト	기진맥진∥t	0
へとへと	기진맥진∥t	0
ベトベト	끈적끈적∥t	0
ヘナヘナ	비실비실∥t	0
へなへな	비실비실∥t	0
ヘナヘナッ	비실비실∥t	0
ヘニャヘニャ	흐물흐물∥t	0
へにゃへにゃ	흐물흐물∥t	0
ヘニャヘニャッ	흐물흐물∥t	0
ヘベレケ	헤롱헤롱∥t	0
へべれけ	헤롱헤롱∥t	0
ヘラヘラ	실실∥t	0
へらへら	실실∥t	0
ヘロヘロ	비실비실∥t	0
へろへろ	비실비실∥t	0
ヘロヘロッ	비실비실∥t	0
ベロリベロリ	할짝할짝∥t	0
ほいほい	척척∥t	0
ボインボイン	빵빵∥t	0
ぼいんぼいん	빵빵∥t	0
ボカボカ	콩콩∥t	0
ぼかぼか	콩콩∥t	0
ポキポキ	뚜둑뚜둑∥t	0
ぽきぽき	뚜둑뚜둑∥t	0
ボキボキ	뽀각뽀각∥t	0
ぼきぼき	뽀각뽀각∥t	0
ホクホク	싱글싱글∥t	0
ほくほく	싱글싱글∥t	0
ボコボコ	불퉁불퉁∥t	0
ぼこぼこ	불퉁불퉁∥t	0
ポコポコ	퍽퍽∥t	0
ぽこぽこ	퍽퍽∥t	0
ボコボコッ	퉁퉁∥t	0
ボサボサ	부스스∥t	0
ぼさぼさ	부스스∥t	0
ホジホジ	부비부비∥t	0
ほじほじ	부비부비∥t	0
ボソボソ	소곤소곤∥t	0
ボタボタ	뚝뚝∥t	0
ぼたぼた	뚝뚝∥t	0
ポタポタ	뚝뚝∥t	0
ぽたぽた	뚝뚝∥t	0
ボタボタッ	뚝뚝∥t	0
ポタポタッ	뚝뚝∥t	0
ボチボチ	슬슬∥t	0
ぼちぼち	슬슬∥t	0
ポチポチ	총총∥t	0
ぽちぽち	총총∥t	0
ボッコボッコ	퉁퉁∥t	0
ぼっこぼっこ	퉁퉁∥t	0
ポツポツ	띄엄띄엄∥t	0
ぽつぽつ	띄엄띄엄∥t	0
ポテポテ	아장아장∥t	0
ぽてぽて	아장아장∥t	0
ホトホト	톡톡∥t	0
ほとほと	톡톡∥t	0
ポフポフ	팡팡∥t	0
ぽふぽふ	팡팡∥t	0
ボヨンボヨン	푹신푹신∥t	0
ぼよんぼよん	푹신푹신∥t	0
ボリボリ	긁적긁적∥t	0
ぼりぼり	긁적긁적∥t	0
ポリポリ	긁적긁적∥t	0
ぽりぽり	긁적긁적∥t	0
ほれぼれ	황홀황홀∥t	0
ホワホワ	둥실둥실∥t	0
ほわほわ	둥실둥실∥t	0
ポワポワ	어리버리∥t	0
ぽわぽわ	어리버리∥t	0
ポワポワッ	어리버리∥t	0
マジマジ	초롱초롱∥t	0
まじまじ	초롱초롱∥t	0
ミシミシ	삐걱삐걱∥t	0
みしみし	삐걱삐걱∥t	0
ミチミチ	가득가득∥t	0
みちみち	가득가득∥t	0
ミチミチッ	가득가득∥t	0
ミリミリ	우직우직∥t	0
みりみり	우직우직∥t	0
ムキムキ	불끈불끈∥t	0
むきむき	불끈불끈∥t	0
ムキュムキュ	울컥울컥∥t	0
むきゅむきゅ	울컥울컥∥t	0
ムクムク	뭉실뭉실∥t	0
むくむく	뭉실뭉실∥t	0
ムグムグ	우물우물∥t	0
むぐむぐ	우물우물∥t	0
ムシャクシャ	우걱우걱∥t	0
むしゃくしゃ	우걱우걱∥t	0
ムシャムシャ	우걱우걱∥t	0
むしゃむしゃ	우걱우걱∥t	0
ムチムチ	포동포동∥t	0
むちむち	포동포동∥t	0
ムチュムチュ	므츄므츄∥t	0
むちゅむちゅ	므츄므츄∥t	0
ムニムニ	물렁물렁∥t	0
むにむに	물렁물렁∥t	0
ムニャムニャ	음냐음냐∥t	0
むにゃむにゃ	음냐음냐∥t	0
ムニュムニュ	음냐음냐∥t	0
むにゅむにゅ	음냐음냐∥t	0
ムヤミヤ	마구마구∥t	0
むやみや	마구마구∥t	0
ムヤミヤタラ	마구마구∥t	0
むやみやたら	마구마구∥t	0
ムラムラ	불끈불끈∥t	0
メーメー	메에메에∥t	0
メキメキ	부쩍부쩍∥t	0
めきめき	부쩍부쩍∥t	0
メソメソ	훌쩍훌쩍∥t	0
メラメラ	활활∥t	0
メリメリ	우지직∥t	0
めりめり	우지직∥t	0
メロメロ	헤롱헤롱∥t	0
めろめろ	헤롱헤롱∥t	0
モガモガ	우걱우걱∥t	0
もがもが	우걱우걱∥t	0
モギュモギュ	냠냠∥t	0
もぎゅもぎゅ	냠냠∥t	0
モゴモゴ	우물우물∥t	0
もごもご	우물우물∥t	0
モコモコ	푹신푹신∥t	0
もこもこ	푹신푹신∥t	0
モサモサ	꾸물꾸물∥t	0
もさもさ	꾸물꾸물∥t	0
モジモジ	머뭇머뭇∥t	0
モシャモシャ	북실북실∥t	0
もしゃもしゃ	북실북실∥t	0
もしゃもしゃもしゃ	북실북실북실∥t	0
モジャモジャ	북실북실∥t	0
もじゃもじゃ	북실북실∥t	0
もじゃもじゃもじゃ	북실북실북실∥t	0
モタモタ	어물어물∥t	0
もたもた	어물어물∥t	0
モチモチ	쫄깃쫄깃∥t	0
もちもち	쫄깃쫄깃∥t	0
モニュモニュ	뭉클뭉클∥t	0
もにゅもにゅ	뭉클뭉클∥t	0
モフモフ	복실복실∥t	0
もふもふ	복실복실∥t	0
モミモミ	만지작만지작∥t	0
もみもみ	만지작만지작∥t	0
モヤモヤ	뭉게뭉게∥t	0
モワモワ	몽글몽글∥t	0
もわもわ	몽글몽글∥t	0
ヤイノヤイノ	바득바득∥t	0
やいのやいの	바득바득∥t	0
ヤキモキ	안절부절∥t	0
やきもき	안절부절∥t	0
ヤワヤワ	보들보들∥t	0
やわやわ	보들보들∥t	0
ユサユサ	흔들흔들∥t	0
ゆさゆさ	흔들흔들∥t	0
ユラユラ	흔들흔들∥t	0
ゆらゆら	흔들흔들∥t	0
ユルユル	느슨느슨∥t	0
ゆるゆる	느슨느슨∥t	0
ヨタヨタ	비틀비틀∥t	0
よたよた	비틀비틀∥t	0
ヨチヨチ	아장아장∥t	0
ヨロヨロ	비틀비틀∥t	0
よろよろ	비틀비틀∥t	0
れるれる	날름날름∥t	0
レロレロ	날름날름∥t	0
れろれろ	날름날름∥t	0
レロレロッ	날름날름∥t	0
ワイワイ	와글와글∥t	0
ワキワキ	두근두근∥t	0
わきわき	두근두근∥t	0
ワクワク	두근두근∥t	0
わくわく	두근두근∥t	0
ワシャワシャ	스글스글∥t	0
わしゃわしゃ	스글스글∥t	0
ワシワシ	조물조물∥t	0
わしわし	조물조물∥t	0
ワタワタ	허둥지둥∥t	0
わたわた	허둥지둥∥t	0
ワナワナ	와들와들∥t	0
わなわな	와들와들∥t	0
わらわら	어질어질∥t	0
ワンワン	왕왕∥t	0
わんわん	왕왕∥t	0
ングング	얌얌∥t	0
んぐんぐ	얌얌∥t	0
恐る恐る	흠칫흠칫∥t	0
途切れ途切れ	띄엄띄엄∥t	0
書き書き	끄적끄적∥t	0
愚図愚図	꾸물꾸물∥t	0
絶え絶え	끊어질듯 끊어질듯∥t	0
切れ切れ	끊길듯 끊길듯∥t	0
喘ぎ喘ぎ	헐떡헐떡∥t	0
透け透け	보일듯 말듯∥t	0
惚れ惚れ	황홀황홀∥t	0
涸れ涸れ	바싹바싹∥t	0
しとしと	보슬보슬∥t	0
シトシト	보슬보슬∥t	0
静々	조용조용∥t	0
ブヨブヨ	포동포동∥t	0
ソソクサ	허둥지둥∥t	0
ぽつりぽつり	띄엄띄엄∥t	0
ポツリポツリ	띄엄띄엄∥t	0
じゃらじゃら	짤랑짤랑∥t	0
あわあわ	아와아와∥t	0
にゅるにゅる	미끄덩미끄덩∥t	0
ニュルニュル	미끄덩미끄덩∥t	0
ベットベト	끈적끈적∥t	0	//こんなにベットベトでニュルニュルになってるよ？
びっくんびっくん	흠칫흠칫∥t	0
しゅるしゅる	스륵스륵∥t	0
甘々	달콤달콤∥t	0
ふくふく	푹신푹신∥t	0
ちりんちりん	치링치링∥t	0
こつりこつり	탁탁∥t	0	//こつりこつりと、杖を地面に突いて、
どたんばたん	퉁탕퉁탕∥t	0
どったんばったん	퉁탕퉁탕∥t	0
ビッキビキ	꿈틀꿈틀∥t	0
苛々	안절부절∥t	0	//ちょっと苛々してて
ごとごと	덜걱덜덕∥t	0
ゴトゴト	덜걱덜덕∥t	0
どぼどぼ	느릿느릿∥t	0	//そう言ってどぼどぼとコップに焼酎を注ぐ柚子ちゃん。
イキイキ	생생∥t	0	//特に署長は前以上にイキイキしてますよ。
ドキドキ	두근두근∥t	0
ドッキドッキ	두근두근∥t	0
ドッキドキ	두근두근∥t	0
どきどき	두근두근∥t	0
どっきどっき	두근두근∥t	0
どっきどき	두근두근∥t	0
盛り盛り	와작와작∥t	0	//フルーツ盛り盛りのトロピカルドリンク
ぽんぽん	팡팡∥t	0
ぽんぽんぽん	팡팡팡∥t	0
ぷつりぷつり	툭툭∥t	0	//ぷつりぷつりと切れてゆく。
ふらふら	휘청휘청∥t	0	//今までふらふらと歩いていたんだ。
フラフラ	휘청휘청∥t	0	//今までふらふらと歩いていたんだ。
ぽそぽそ	소곤소곤∥t	0	//ぽそぽそと小さな声でしゃべってたので
ポソポソ	소곤소곤∥t	0	//ぽそぽそと小さな声でしゃべってたので
ぼやぼや	어리버리∥t	0
ボヤボヤ	어리버리∥t	0
ぽやぽや	어리버리∥t	0
ポヤポヤ	어리버리∥t	0
ブインブイン	붕붕∥t	0
しゃわしゃわ	살랑살랑∥t	0
喧々囂々	왁자지껄∥t	0
喧喧囂囂	왁자지껄∥t	0
とことこ	타박타박∥t	0
トコトコ	타박타박∥t	0
ちゃっちゃっ	착착∥t	0
チャッチャッ	착착∥t	0
よれよれ	구깃구깃∥t	0
ヨレヨレ	구깃구깃∥t	0
きゃわきゃわ	꺄와꺄와∥t	0
ごしょごしょ	중얼중얼∥t	0
わさわさ	술렁술렁∥t	0
ちょこちょこ	촐랑촐랑∥t	0
きゃらきゃら	키득키득∥t	0
キャラキャラ	키득키득∥t	0
どくりどくり	쿨렁쿨렁∥t	0
ハァハァハァ	하아하아하아∥t	0
ハァハァ	하아하아∥t	0
ハアハアハア	하아하아하아∥t	0
ハアハア	하아하아∥t	0
ギャンギャン	캉캉∥t	0
ギャンギャンギャン	캉캉캉∥t	0
けらけら	깔깔∥t	0
ぎっこんばっこん	쿵덕쿵덕∥t	0
ぎったんばっこん	쿵덕쿵덕∥t	0
ぎっこんばったん	쿵덕쿵덕∥t	0
ギッコンバッコン	쿵덕쿵덕∥t	0
ギッタンバッコン	쿵덕쿵덕∥t	0
ギッコンバッタン	쿵덕쿵덕∥t	0
わぁわぁ	와아와아∥t	0
わぁわぁわぁ	와아와아와아∥t	0
ぱっぱっ	팟팟∥t	0
ぱっぱっぱっ	팟팟팟∥t	0
くうくう	쿠우쿠우∥t	0
くうくうくう	쿠우쿠우쿠우∥t	0
びっきびき	꿈틀꿈틀∥t	0
ちゅぱちゅぱ	츄파츄파∥t	0


//▰ ~り형 ('부)
アッサリ	시원스럽게∥r	0
アッサリッ	시원스럽게∥r	0
ウットリ	멍하게∥r	0
がくり	풀썩∥r	0
ガチャリ	짤각∥r	0
カチャリ	철컥∥r	0
かちゃり	철컥∥r	0
ガチャリッ	짤각∥r	0
カチャリッ	철컥∥r	0
かちり	짤깍∥r	0
がっくり	풀썩∥r	0
カッチリ	꼭∥r	0
ガッチリ	단단히∥r	0
カッチリッ	꼭∥r	0
ガッツリ	마음껏∥r	0	//おれはがっつり食うから、
がっつり	마음껏∥r	0	//おれはがっつり食うから、
ガッツリッ	마음껏∥r	0	//おれはがっつり食うから、
ぎっくり	삐끗∥r	0
ギックリ	움찔∥r	0
ギックリッ	움찔∥r	0
ギッシリ	가득∥r	0
ギッシリッ	가득∥r	0
キッチリ	빈틈없이∥r	0
キッチリッ	빈틈없이∥r	0
キッパリ	단호히∥r	0
キッパリッ	단호히∥r	0
ぎろり	번득∥r	0
ぐさり	푸욱∥r	0
くしゃり	꾸깃∥r	0
ぐしゃり	폭삭∥r	0
クチュリ	질척∥r	0
くちゅり	질척∥r	0
クチュリッ	질척∥r	0
クッキリ	선명하게∥r	0
クッキリッ	선명하게∥r	0
クッショリ	흠뻑∥r	0
グッショリ	흠뻑∥r	0
クッショリッ	흠뻑∥r	0
グッショリッ	흠뻑∥r	0
グッスリ	푹∥r	0
クッチュリ	질척∥r	0
クッチュリッ	질척∥r	0
グニャリ	흐늘흐늘∥r	0
ぐにゃり	흐늘흐늘∥r	0
ぐびり	꿀꺽∥r	0
くるり	빙글∥r	0
クルリと	휙∥r	0	//そしてクルリとこちらを向くと、大きな目をパッチリと開いて
ゲッソリ	홀쭉∥r	0
ゲッソリッ	홀쭉∥r	0
ごきゅり	꿀꺽∥r	0
こくり	끄덕∥r	0
ごろり	데구르르∥r	0	//西瓜をごろりと転がす
サックリ	싹둑∥r	0
さっくり	싹둑∥r	0
ザックリ	썩둑∥r	0
ざっくり	썩둑∥r	0
サックリッ	싹둑∥r	0
ザックリッ	썩둑∥r	0
シッカリ	확실히∥r	0
ジックリ	차분히∥r	0
ジックリッ	차분히∥r	0
シットリ	촉촉히∥r	0
しっとり	촉촉히∥r	0
シットリッ	촉촉히∥r	0
シャッキリ	꼿꼿하게∥r	0
しゃっきり	꼿꼿하게∥r	0	//気持がしゃっきりした
シャッキリッ	꼿꼿하게∥r	0
じゅるり	주르륵∥r	0
ションボリ	맥없이∥r	0
ションボリッ	맥없이∥r	0
じろり	흘깃∥r	0
じわり	차츰∥r	0
じんわり	서서히∥r	0
ずきり	욱신∥r	0
ずしり	묵직∥r	0
スッキリサッパリ	개운상쾌∥r	0
すっきりさっぱり	개운상쾌∥r	0
ズッシリ	묵직∥r	0
ずっしり	묵직∥r	0
ズッシリッ	묵직∥r	0
スッパリ	싹둑∥r	0
すっぱり	싹둑∥r	0
スッパリッ	싹둑∥r	0
ズッポリ	쭈욱∥r	0
ずっぽり	쭈욱∥r	0
スッポリ	푹∥r	0
ズッポリッ	쭈욱∥r	0
スッポリッ	푹∥r	0
ずぶり	푸욱∥r	0
するり	스르륵∥r	0
ずるり	주르룩∥r	0
ぞくり	흠칫∥r	0
そろり	스르르∥r	0
ぞわり	섬칫∥r	0
タップリ	충분히∥r	0
タップリッ	충분히∥r	0
ちくり	따끔∥r	0
ちらり	슬쩍∥r	0
ちろり	언뜻∥r	0
つるり	반들반들∥r	0
デップリ	뒤룩뒤룩∥r	0
でっぷり	뒤룩뒤룩∥r	0
どきり	철렁∥r	0
ドッカリ	털썩∥r	0	//不作法にドッカリとソファーに座った。
ドッカリッ	털썩∥r	0
ドッキリ	철렁∥r	0
どっきり	철렁∥r	0
トロリ	걸죽∥r	0
とろり	걸죽∥r	0
ドロリ	걸죽∥r	0
どろり	걸죽∥r	0
どんより	흐리멍텅∥r	0
にこり	생긋∥r	0
ニッコリ	생긋∥r	0
ニッコリッ	생긋∥r	0
にゅるり	미끌∥r	0
ニンマリ	빙그레∥r	0
ニンマリッ	빙그레∥r	0
ぬちゃり	질척∥r	0
ぬちゅり	질퍽∥r	0
ぬっぷり	쑤욱∥r	0
ヌルリ	미끌∥r	0
ぬるり	미끌∥r	0
ヌルリッ	미끌∥r	0
ねっとり	끈적∥r	0
のっぺり	두리뭉실∥r	0
ぱくり	뻐끔∥r	0
ぱしゃり	찰칵∥r	0
パックリ	빠끔히∥r	0
パックリッ	빠끔히∥r	0
バッサリ	싹둑∥r	0
ばっさり	싹둑∥r	0
バッサリッ	싹둑∥r	0
ばったり	털썩∥r	0
パッチリ	또렷이∥r	0	//目をパッチリと開いて
バッチリ	확실히∥r	0
ばっちり	확실히∥r	0
バッチリッ	확실히∥r	0
びくり	흠칫∥r	0
ぴくり	흠칫∥r	0
ぴしゃり	철썩∥r	0
びしり	퍼벅∥r	0
ぴっしゃり	철썩∥r	0
ビッショリ	흠뻑∥r	0
ビッショリッ	흠뻑∥r	0
ピッタリ	딱∥r	0
ピッタリッ	딱∥r	0
ひょっくり	불쑥∥r	0
ひょっこり	불쑥∥r	0
ぷっくり	볼록∥r	0
プックリ	불록∥r	0
ふらり	훌쩍∥r	0
ぶるり	브르르∥r	0
フンワリ	둥실∥r	0
ふんわり	둥실∥r	0
ぺこり	꾸벅∥r	0
ベッタリ	찰싹∥r	0
ベッタリッ	찰싹∥r	0
ベットリ	흠뻑∥r	0
ベットリッ	흠뻑∥r	0
ぺろり	낼름∥r	0
べろり	할짝∥r	0
ぽかり	딱∥r	0
ぼそり	중얼∥r	0
ポッカリ	뻐끔∥r	0
ぽっかり	뻐끔∥r	0
ポッカリッ	뻐끔∥r	0
ぽっくり	덜컥∥r	0
ボッコリ	볼록∥r	0
ぼっこり	볼록∥r	0
ポッコリ	볼록∥r	0
ぽっこり	볼록∥r	0
ボッコリッ	볼록∥r	0
ポッコリッ	볼록∥r	0
ほっそり	호리호리∥r	0
ぽとり	툭∥r	0
ぼろり	도르륵∥r	0
ぽろり	툭∥r	0
ほんのり	어렴풋이∥r	0
みっちり	충분히∥r	0
むくり	벌떡∥r	0
ムッチリ	포동포동∥r	0
むっちり	포동포동∥r	0
もっちり	쫄깃∥r	0
ゆらり	흔들∥r	0
れろり	할짝∥r	0
ヒッソリ	고요히∥r	0
ふにゅり	말랑∥r	0
フニュリ	말랑∥r	0
ひんやり	썰렁∥r	0
ヒンヤリ	썰렁∥r	0
ふうわり	둥실∥r	0
ぽっちゃり	포동포동∥r	0	//本人はぽっちゃり気味の体型を気にしているが、
コッソリ	살짝∥r	0
ジットリ	축축히∥r	0
小ぢんまり	아담하게∥r	0
ぱったり	딱∥r	0
むっくり	봉긋∥r	0
薄ぼんやり	희미하게∥r	0
ぽってり	통통∥r	0
びしゃり	철푸덕∥r	0
ぞぶり	후루룩∥r	0
こりり	까드득∥r	0
ぬらり	미끌∥r	0
こぽり	부글∥r	0
きょろり	힐끔∥r	0
ぎょろり	힐긋∥r	0


//▰ 그외 형태 ('부) (원어나 번역어가 ABxB가 아님)
ドンピシャ	딱∥t	0	//딱 들어맞는 모양. サイズはどんぴしゃりだ
どんぴしゃ	딱∥t	0	//딱 들어맞는 모양. サイズはどんぴしゃりだ
ドンピシャリ	딱∥t	0	//딱 들어맞는 모양. サイズはどんぴしゃりだ
どんぴしゃり	딱∥t	0	//딱 들어맞는 모양. サイズはどんぴしゃりだ
フックラ	포동포동∥t	0
ふっくら	포동포동∥t	0
ブックラ	포동포동∥t	0
ぶっくら	포동포동∥t	0
プックラ	포동포동∥t	0
ぷっくら	포동포동∥t	0
ペタンコ	납작∥t	0
ぺたんこ	납작∥t	0
ペッタンコ	납작∥t	0
ぺったんこ	납작∥t	0
ホンワカ	평온∥t	0	//ほんわかとした気分
ほんわか	평온∥t	0	//ほんわかとした気分
散り散り	산산히∥t	0	//一家が散り散りになる
ツラツラ	곰곰히∥t	0
しみじみ	절절히∥t	0
染染	절절히∥t	0
くんずほぐれつ	엎치락 뒤치락∥t	0
離ればなれ	따로 따로 떨어짐	1
離れ離れ	따로 따로 떨어짐	1
はなればなれ	따로 따로 떨어짐	1
ドサクサ	혼잡	1
だましだまし	조심조심	0
騙し騙し	조심조심	0

//'끝







//█████████████████████████████████████████████████████████████████████████████
// #.'기타
//█████████████████████████████████████████████████████████████████████████████
//반복
いいこいいこ	착한 아이 착한 아이	0
いいっていいって	괜찮다고 괜찮다고	0
いけないいけない	안 된다 안 된다	0
これこれ	이거이거	1
してないしてない	안 해 안 해	0
してるしてる	하고 있다 하고 있다	0
しないしない	안 해 안 해	0
そうかそうか	그런가 그런가	0
そうだったそうだった	그랬다 그랬다	0
そうだったそだった	그랬다 그랬다	0	//♞そだったそだった (예비1 차수에서 そうだったそだった로 바뀜)
そうだろうそうだろう	그렇겠지 그렇겠지	0
そうだろそうだろう	그렇겠지 그렇겠지	0	//♞そうだろそうだろ (사투리 차수에서 そうだろそうだろう로 바뀜)
そうでしょうそうでしょう	그렇겠죠 그렇겠죠	0
そうでしょそうでしょ	그렇겠죠 그렇겠죠	0
そうですかそうですか	그렇습니까 그렇습니까	0
そうですそうです	그렇습니다 그렇습니다	0
そうですよそうです	그래요 그래요	0
そうともそうとも	그럼그럼	0
そうなのそうなの	그래 그래	0
そーそー	그래그래	0	//「そーそー。さあ、はやく行こー！！」
だからだから	그러니까 그러니까	0
だってだって	하지만 하지만	0
ないない	없어 없어	0
なんだなんだ	뭐야 뭐야	0
なんだよなんだよ	뭐야 뭐야	0
待て待て	기다려 기다려	0
待て待って	기다려 기다려	0
何だなんだ	뭐야 뭐야	0	//なんだなんだ (연어차수에서 何だなんだ로 바뀜)
何だよなんだよ	뭐야 뭐야	0	//なんだよなんだよ (연어차수에서 何だよなんだよ로 바뀜)
い～のい～の	괜~찮아 괜~찮아	0
いいのい～の	괜~찮아 괜~찮아	0	//♞
やったやった	해냈다 해냈다	0	//わー、やったやった、やりましたーっ！
嫌だやだ	싫다 싫다	0	//やだやだ不潔なアンモニアの臭い。
分かるわかる	알아 알아	0	//♞
分かっているわかってる	알고 있다 알고 있다	0	//♞わかってるわかってる
分かっているわかっている	알고 있다 알고 있다	0	//♞わかってるわかってるわかってる。
へーきへーき	괜찮아 괜찮아	0	//「へーきへーき。前から風邪なんか引いたことないし」
見て見て	봐 봐	0
おいおいおい	이봐 이봐 이봐	0
鏡よ鏡よ	거울아 거울아	0
よくないよくない	좋지 않아 좋지 않아	0
かゆいかゆい	가렵다 가렵다	0
すまぬすまない	미안하다 미안하다	0	//♞すまぬすまぬ
怒るな怒るな	화내지마 화내지마	0


//'임시
シャキッ	산뜻	0
しくしくしく	훌쩍 훌쩍 훌쩍	0
い・や	싫·어	0
