//필터링에서 사용된 더미 명사
乘名	名:	1	//명사 접두
梦名	#M二	1	//명사 접미
梦彼	#N二	1	VHn	//호칭명사 및 이름 접미
乘動	動:	1	//동사생성 접두
乘形	形:	1	//형용사생성 접두
乘受	受:	1	//수동형 접두
乘加	加:	1	//더미용 명사
戰戰	#M二	1	//~する형에서 쓰이는 접미어로, 다른 등록된 명사가 있는 경우, #M가 됨.
くん梦彼	군#N二	1	VHn	//君
クン梦彼	군#N二	1	VHn	//君
ちゃん梦彼	짱#N二	1	VHn	//ちゃん

//#.필터링으로 조작된 어휘들
//▀▀▀▀▀▀▀▀▀▀▀▀▀▀▀▀▀▀▀▀▀▀▀▀▀▀▀▀▀▀▀▀▀▀▀▀▀▀▀▀▀▀▀▀▀▀▀▀▀▀▀▀▀▀▀▀▀▀▀▀▀▀▀▀▀▀▀▀▀▀▀▀▀▀▀▀▀
//い 형용사 자연스런 번역
うれしゎ形	기뻐	0
うれっしゎ形	기뻐	0
おかしゎ形	이상해	0
おっかしゎ形	이상해	0
おっそゎ形	늦다	0
くやしゎ形	분해	0
くやっしゎ形	분해	0
こわゎ形	무서워	0
すごゎ形	굉장해	0
すごぉゎ形	굉장해	0
ひどゎ形	너무해	0
やばゎ形	위험해	0
//
あぶゎ形	위험해	0
アブゎ形	위험해	0
いらゎ形	필요없어	0
危ゎ形	위험해	0
//
甘ゎ形	달다	0
高ゎ形	높다	0
熱ゎ形	뜨거워	0
早ゎ形	빨라	0	//「早っ！？」
遅ゎ形	늦어	0
多ゎ形	빨라	0
違ゎ形	달라	0
寒ゎ形	추워	0	//寒っ
やべゎ形	위험해	0

//호칭명사
イタズラッ子梦彼	장난꾸러기#N	1	VHn	//인간 : いたずらっ子
ウスノロ梦彼	얼간이#N	1	VHn	//인간 : うすのろ
コイツ梦彼	이 녀석#N	1	VHn	//인간 :
シニガミ梦彼	사신#N	1	VGn	//신(성인)
デカブツ梦彼	멍청이#N	1	VHn	//인간 : でかぶつ
ハニカミヤ梦彼	부끄럼쟁이#N	1	VHn	//인간 : はにかみや
ヘンシツシャ梦彼	변절자#N	1	VHn	//인간 : へんしつしゃ
ワガ君梦彼	나랏님#N	1	VHn	//인간 : わが君
//
アイツ梦彼	저 녀석#N	1	VHn	//인간 :
ソイツ梦彼	그 녀석#N	1	VHn	//인간 :
アヤツ梦彼	저 녀석#N	1	VHn	//인간 :
ソヤツ梦彼	그 녀석#N	1	VHn	//인간 :
アクマ梦彼	악마#N	1	VHn	//인간 :
アニキ梦彼	형님#N	1	VHn	//인간 :
アニキー梦彼	형님#N	1	VHn	//인간 :
オクテ梦彼	늦깎이	1
ガキ梦彼	꼬마#N	1	VHn	//인간 : ガキ、悪ガキ
ケモノ梦彼	짐승#N	1	VAm	//동물
シャケ梦彼	연어#N	1	VAm	//동물
セフレ梦彼	섹스프렌드#N	1	VHn	//인간 : セフレ
ゾウ梦彼	코끼리#N	1	VAm	//동물
チカン梦彼	치한#N	1	VHn	//인간 :
ブス梦彼	오크#N	1	VHn	//인간 : ブス
ボウヤ梦彼	꼬마#N	1	VHn	//인간 : ブス
マメ男梦彼	성실남#N	1	VHn	//인간 :
パギャル梦彼	파갸루#N	1	VHn	//인간 :
メンクイ梦彼	얼굴 밝히는 사람#N	1	VHn	//인간
オジイサン梦彼	할아버지#N	1	VHn	//인간
//
害児梦彼	장애아#N	1	VHn	//인간 : 害児
鵺梦彼	누에[ぬえ]#N	1	VAm	//동물
蠅梦彼	파리#N	1	QAE	//곤충류
佛梦彼	부처#N	1	VGn	//신(성인)
牡梦彼	수컷#N	1	VAm	//동물
牝梦彼	암컷#N	1	VAm	//동물
奥梦彼	사모#N	1	VHn	//인간 : 奥さま
仏梦彼	부처#N	1	VGn	//신(성인)
現生徒梦彼	현학생#N	1	VHn	//인간 :
お婿梦彼	신랑#N	1	VHn	//인간 :
//기타명사
イイガカリ梦名	트집	1
イタズラ心梦名	장난끼	1	UFl	//감정
生ケ贄梦名	제물	1	//生け贄
ウサ耳梦名	토끼귀	1	VBp	//신체부위 :
憂イ顔	슬픈 얼굴	1	VBp	//신체부위 :
海岸通リ	부둣가	1	VPl	//장소 : 海岸通り (かいがんとおり)
喰イップリ梦名	먹는 모습	1	//喰いっぷり
コメカミ梦名	관자놀이	1	VBp	//신체부위 :
シビン梦名	요강	1
ジゴウジトク梦名	자업자득	1
ジゴクミミ梦名	지옥귀[地獄耳]	1
タイ焼キ梦名	붕어빵	1	VFd	//음식
ハジッコ梦名	가장자리	1	VPl	//장소 :
ハヤトチリ梦名	지레짐작	1
身ジロギ梦名	미동	1
良イ悪イ梦名	좋고 나쁨	1
及ビ腰梦名	엉거주춤한 자세	1	//及び腰にもならないの！
//
アクセ梦名	악세사리	1	VAc	//장신구
アザ梦名	멍	1
アッタマ梦名	머리	1	VBp	//신체부위 :
イチコロ梦名	일살[一殺]	1
イボ梦名	돌기	1
ウインク梦名	윙크	1
エッセー梦名	에세이	1
オンブ梦名	어부바	1
カス梦名	찌꺼기	1
カンケー梦名	관계	1
カンスト梦名	카운터스톱	1	//
ガセ梦名	엉터리	1
ガバマン梦名	헐렁보지	1	VBp	//신체부위 :
キズナ梦名	인연	1
クリ梦名	클리	1	VBp	//신체부위 :
シカト梦名	무시	1	//俺はシカトでも菜桜子には答えるのかよ……。
タライ梦名	대야	1
タンス梦名	옷장	1	VFn	//가구
ダメモト梦名	밑져야 본전	1
ツテ梦名	연줄	1
ツバ梦名	침	1
デパ梦名	백화점	1	VPl	//장소 :
トゲ梦名	가시	1
ハッタリ梦名	허세	1
ヒダ梦名	주름	1
ビョーキ梦名	병	1	UTi	//질병 :
ビンタ梦名	귀싸대기	1
フリマ梦名	프리마켓	1	VPl	//장소 :
ヘドロ梦名	진흙탕	1
マッパ梦名	알몸	1
メンテ梦名	메인터넌스	1
モヤ梦名	안개	1
メンチ梦名	다진 고기	1	VFd	//음식
メシ梦名	밥	1	VFd	//음식
イチ梦名部分	제일 중요한 부분	1
中ボス梦名	중간보스#N	1	VHn	//인간 :
マンガ喫茶梦名	만화 카페	1	VPl	//장소 :
ケー番梦名	폰번	1
ラム肉梦名	어린 양고기	1	VFd	//음식
食いカス梦名	먹은 찌꺼기	1	VFd	//음식(음료)
メシベ梦名	암술	1
オシベ梦名	수술	1
ツッパリ梦名	버팀목	1
セカイ梦名	세계	1	VPl	//장소 :
セカイッ梦名	세계	1	VPl	//장소 :
ソッコー梦名	즉시	0	//명사는 아니지만...
チンカス梦名	좆밥	1
ツンケン梦名	뾰루퉁	0	//なんでそんなにツンケンしてるのさー。
カン蹴り梦名	깡통차기	1
ワン切り梦名	원링 스팸	1
ホウキ梦名	빗자루	1
マン汁梦名	보짓물	1	VLu	//분비물
タンキニ梦名	탱키니	1	VCp	//의복 : 탱크탑 비키니
スク水梦名	학교수영복	1	VCp	//의복
//
年梦名	나이	1
額梦名	이마	1	VBp	//신체부위 :
鼾梦名	코골이	1
鎌梦名	낫	1
兜梦名	투구	1	VCp	//의복
蕾梦名	꽃봉오리	1
蔓梦名	덩굴	1	VPt	//식물 :
髭梦名	수염	1
屁梦名	방귀	1
塀梦名	담	1
臍梦名	배꼽	1	VBp	//신체부위 :
銃梦名	총	1	VTw	//무기 :
雫梦名	물방울	1
骸梦名	사체	1
坂の上梦名	언덕 위	1	VPl	//장소
坂の下梦名	언덕 아래	1	VPl	//장소
紙の上梦名	종이 위	1
紙の下梦名	종이 아래	1
酌梦名	잔	1
大地梦名	대지	1	VPl	//장소 : 空は暗く曇り、大地は枯れ
袋梦名	부대	1
籠梦名	바구니	1
贄梦名	제물	1
貌梦名	용모	1
盆梦名	쟁반	1
許梦名	계신 곳	1	VPl	//장소 : 小走りに公爵の許へやって来ると
歩梦名	걸음	1	//歩を進める毎にその音は
天梦名	하늘	1	//今日も暖かき天からの恵を与えた
尿梦名	오줌	1	VLu	//분비물 : 鋼鉄の貞操帯は、臭気を放つ彼女の尿にまみれながら役目を終えたのだ。
了解梦名	양해[了解]	1
肋梦名	늑골	1	VBp	//신체부위 :
側梦名	곁	1	VPl	//장소
鱚梦名	어류	1	QAC	//어류
マン肉梦名	보짓살	1	VBp	//신체부위 :
本達梦名	책들	1	VBk	//책
恋話梦名	사랑 이야기	1
恋バナ梦名	사랑 이야기	1
雹梦名	우박	1
お椀梦名	밥공기	1
写メ梦名	사진 메일	1
外ヅラ	밖에서의 인상	1	//外ヅラのいい。
大アリ梦名	많이 있음	1	//こっちは大アリだ。
大アリッ梦名	많이 있음	1	//こっちは大アリッ。
すり傷梦名	스친 상처	1
紐パン梦名	끈팬티	1	VCp	//의복
紐パンッ梦名	끈팬티	1	VCp	//의복
壁ドン梦名	벽 꽝[壁ドン]	1	//남성이 여성을 벽에 밀어붙이고 한쪽 손으로 벽을 쾅 치는 행위.
壁ドンッ梦名	벽 꽝[壁ドン]	1	//남성이 여성을 벽에 밀어붙이고 한쪽 손으로 벽을 쾅 치는 행위.
水の上梦名	물 위	1
二言梦名	두 말	1
鎧梦名	갑옷	1	VCp	//의복
格ゲー梦名	격투게임	1
膝上梦名	무릎 위	1	//膝上２０センチ
中の上梦名	중상[中の上]	1
中の下梦名	중하[中の下]	1
背たけ梦名	신장	1
晩メシ梦名	저녁밥	1	VFd	//음식(음료)
何カップ梦名	무슨 컵	1
万死梦名	만번 죽음	1	//万死に値する。
変顔梦名	우스운 얼굴	1
字面梦名	자면[字面]	1
薪梦名	장작	1
//+.
是毛非梦名	시비[是非]	1	//是非も無い事。
//수사 관련
戰年目	@@년째	1	//五二年目。五年目。何年目。幾年目。
戰周目	@@주째	1	//二周目も。五周目。何周目。幾周目。
戰日目	@@일째	1	//二日目。五日目。何日目。幾日目。
戰分目	@@분째	1	//二分目。五分目。何分目。幾分目。
戰本目	@@개째	1	//二本目。五本目。何本目。幾本目。
戰度目	@@번째	1	//二度目。五度目。何度目。幾度目。
戰歩目	@@걸음째	1	//１歩目。
戰杯目	@@잔째	1	//二杯目。五杯目。何杯目。幾杯目。
戰口目	@@입째	1	//二口目。五口目。何口目。幾口目。
戰回目	@@회째	1	//二回目。五回目。何回目。幾回目。
戰撃目	@@격째	1	//二撃目。五撃目。何撃目。幾撃目。
戰発目	@@발째	1	//二発目。五発目。何発目。幾発目。
戰合目	@@합째	1	//二合目。五合目。何合目。幾合目。
戰点目	@@점째	1	//二点目。五点目。何点目。幾点目。
戰限目	@@교시째	1	//二限目。五限目。何限目。幾限目。
戰件目	@@건째	1	//二件目。五件目。何件目。幾件目。
戰人目	@@인째	1	//二人目。五人目。何人目。幾人目。
戰代目	@@대째	1	//二代目。五代目。何代目。幾代目。
戰時間目	@@시간째	1	//二時間目。五時間目。何時間目。幾時間目。
戰時限目	@@교시째	1	//二時限目。五時限目。何時限目。幾時限目。
何戰色	무슨 색	1	//何色。
幾戰色	몇 색	1	//幾色。
戰色	@@색	1	//二色。五色。
何戰文字	무슨 문자	1	//何文字。
幾戰文字	몇 문자	1	//幾文字。
戰文字	@@문자	1	//二文字。五文字。
戰人組	@@인조	1	//二人組。五人組。何人組。幾人組。
戰代前	@@대전	1	//二代前。五代前。何代前。幾代前。
戰箇所	@@개소	1	//二箇所も。五箇所。何箇所。幾箇所。
戰階級	@@계급	1	//二階級。五階級。何階級。幾階級。
戰世紀	@@세기	1	//二世紀。五世紀。何世紀。幾世紀。
戰限	@@교시	1	//一限, 二限
戰件	@@건	1	//殺人罪一二件

//동사 관련
お分かり梦名	알고 계심お_敬	1
おわかり梦名	알고 계심お_敬	1
お知り梦名	알고 계심お_敬	1
お有り梦名	있으심お_敬	1
おあり梦名	있으심お_敬	1
お呼び梦名	부르심お_敬	1
お忘れ梦名	잊으심お_敬	1	//もしかしてお忘れだったんですか？
お聞き梦名	(들)물으심お_敬	1

//する
//▂1
首戰戰	≪목을 ㅈㅏ_ㄹㅡㄴ∬&≫	0	//
唾戰戰	≪침뱉ㄴㅡㄴ∬&≫	0	//唾する(つばきする) : 天に唾する者は、必ず報いを受ける。
頬ずり戰戰	≪뺨을 비ㅂㅣㄴ∬&≫	0	//頬ずりする (あご) : 頬ずりしまくる。頬ずりしすぎる。頬ずりになる。
頬擦り戰戰	≪뺨을 비ㅂㅣㄴ∬&≫	0	//頬擦りする
一瞥戰戰	≪슬쩍 ㅂㅗㄴ∬&≫	0	//一瞥する (いちべつ) : 一瞥しまくる。一瞥しすぎる。一瞥になる。
苛立ち戰戰	≪초조ㅎㅏㄴ∬&≫	0	//苛立ちしながら (いらだち) : 苛立ちしまくる。苛立ちしすぎる。苛立ちになる。
うっかり戰戰	≪깜빡&≫	0	//うっかりする。うっかりしすぎる。
蔑ろに戰戰	≪업신여ㄱㅣㄴ∬&≫	0	//蔑ろにした (う) : 蔑ろにされる。蔑ろにしまくる。蔑ろにしすぎる。蔑ろになる。
餌付け戰戰	≪길들ㅇㅣㄴ∬&≫	0	//餌付けする (えづけ)
公戰戰	≪공공연&≫	0	//公にする (おおやけに)。公になる
おしゃぶり戰戰	≪ㅃㅏㄹ∬&≫	0	//おしゃぶりするつもり
おねだり戰戰	≪졸라ㄷㅐㄴ∬&≫	0	//おねだりしまくる。おねだりしすぎる。上手におねだり出来たな。おねだりになる。
開口戰戰	≪개구[開口]&≫	0	//開口する　(かいこう)
火傷戰戰	≪화상 입ㄴㅡㄴ∬&≫	0	//火傷する (かいしょう)
火傷を戰戰	≪화상을 입ㄴㅡㄴ∬&≫	0	//火傷をする (かいしょう)
観念戰戰	≪체념ㅎㅏㄴ∬&≫	0	//観念した (かんねん) : 観念しまくる。観念しすぎる。観念させる。(x)観念になる。
ガン見戰戰	≪뚫어지게 ㅂㅗㄴ∬&≫	0	//ガン見する。ガン見される
着やせ戰戰	≪옷 입으면 날씬ㅎㅏㄴ∬&≫	0	//着やせする
着痩せ戰戰	≪옷 입으면 날씬ㅎㅏㄴ∬&≫	0	//着痩せする
擬戰戰	≪겨ㄴㅜㄴ∬&≫	0	//擬する(ぎする)。擬しすぎる。
釘付けに戰戰	≪못박ㄴㅡㄴ∬&≫	0	//敵を釘付けにする。(くぎずけ) 名画の前に釘付けになる
苦笑戰戰	≪쓴웃음 ㅈㅣㅅㄴㅡㄴ∬&≫	0	//苦笑する (くしょう) : 苦笑しまくる。苦笑しすぎた。苦笑になる。
苦笑を戰戰	≪쓴웃음을 ㅈㅣㅅㄴㅡㄴ∬&≫	0	//苦笑をする
与戰戰	≪가담&≫	0	//与する(くみする)
恋戰戰	≪사랑&≫	0	//恋する(こいそる) : 恋しない。恋しなさい
黙戰戰	≪침묵&≫	0	//黙する(むくそる) : それきり黙した桜守姫さんは
留め戰戰	≪고정&≫	0	//留めする(とめそる) : まずはピンで留めするところからだよ。ピン留めしたいページを表示し。
こけに戰戰	≪바보로##&≫	0	//おれをこけにする。
コケに戰戰	≪바보로##&≫	0	//コケにする。コケにされる。コケにさせる。
ご馳走戰戰	≪대접&≫	0	//ご馳走する (ごちそう) : お茶ぐらいご馳走するからさ。
御馳走戰戰	≪대접&≫	0	//御馳走する (ごちそう) : お茶ぐらい御馳走するからさ。
祝戰戰	≪축하&≫	0	//祝する (しゅくする)
逡巡戰戰	≪망설ㅇㅣㄴ∬&≫	0	//逡巡する (しゅんじゅん) : 逡巡になる。
スルー戰戰	≪through&≫	0	//スルーする : この重要な経験をスルーしていた。
ズル戰戰	≪비겁한 짓&≫	0	//ズルする : ズルしてたんだから。
清々戰戰	≪시원&≫	0	//清々する (せいせい) : 清々しまくる。清々しすぎる。清々になる。
咀嚼戰戰	≪음미ㅎㅏㄴ∬&≫	0	//咀嚼する (そしゃく)
楚々戰戰	≪청초ㅎㅏㄴ∬&≫	0	//楚々した姿 (そそ)
転校戰戰	≪전학&≫	0	//転校する (てんこう) : 転校してきたすっごい美人の子
長居戰戰	≪오래 머무ㄹㅡㄴ∬&≫	0	//長居する。長居させる
長居を戰戰	≪오래 머무르기를 ㅎㅏㄴ∬&≫	0	//長居をする
猫被り戰戰	≪내숭 ㄸㅓㄹ∬&≫	0	//猫被りする (ねこかぶり) : 猫被りしまくる。猫被りしすぎた。猫被りになる。
猫被りを戰戰	≪내숭을 ㄸㅓㄹ∬&≫	0	//猫被りをする
歯軋り戰戰	≪이를 ㄱㅏㄹ∬&≫	0	//歯軋りする。
歯ぎしり戰戰	≪이를 ㄱㅏㄹ∬&≫	0	//歯ぎしりする。
腹ごしらえ戰戰	≪배를 채ㅇㅜㄴ∬&≫	0	//ちょっと腹ごしらえしとくか。
腹拵え戰戰	≪배를 채ㅇㅜㄴ∬&≫	0	//ちょっと腹ごしらえしとくか。
罰戰戰	≪벌ㅎㅏㄴ∬&≫	0	//罰する (ばつする) : "처벌한다"를 "벌한다"로 바꾸기 위함. 罰する。罰される。罰させる。
暇戰戰	≪한가ㅎㅏㄴ∬&≫	0	//暇する (ひまする) : 暇しまくる。暇しすぎる。暇になる。暇してブラブラしてる
御戰戰	≪잘 다ㄹㅜㄴ∬&≫	0	//御する (ぎょする) : これならベルセルクの細胞を御することも出来るだろうし……
びっくり戰戰	≪깜짝 놀ㄹㅏㄴ∬&≫	0	//びっくりさせる
貶戰戰	≪폄하ㅎㅏㄴ∬&≫	0	//貶する (へんする) : 貶させる。貶される。貶させすぎる。
併走戰戰	≪나란히 달ㄹㅣㄴ∬&≫	0	//併走する (へいそう) : 併走しまくる。併走しすぎる。併走になる。
翻弄戰戰	≪희롱ㅎㅏㄴ∬&≫	0	//翻弄する (ほんろう)
丸写し戰戰	≪그대로 베ㄲㅣㄴ∬&≫	0	//丸写しする (まるうつし) : 丸写ししまくる。丸写ししすぎる。(x)丸写しになる。
迷惑戰戰	≪폐끼ㅊㅣㄴ∬&≫	0	//迷惑する、
迷惑を戰戰	≪폐를 끼ㅊㅣㄴ∬&≫	0	//迷惑をされる
悶悶戰戰	≪번민&≫	0	//悶悶しているせいか？
悶々戰戰	≪번민&≫	0	//悶々しているせいか？
モンモン戰戰	≪번민&≫	0	//モンモンしているせいか？
痩せ我慢戰戰	≪오기 부ㄹㅣㄴ∬&≫	0	//痩せ我慢してねぇで、
痩せ我慢は戰戰	≪오기는 부ㄹㅣㄴ∬&≫	0	//痩せ我慢はする
やせ我慢戰戰	≪오기 부ㄹㅣㄴ∬&≫	0	//やせ我慢してねぇで、
やせ我慢は戰戰	≪오기는 부ㄹㅣㄴ∬&≫	0	//やせ我慢はする
ヤセ我慢戰戰	≪오기 부ㄹㅣㄴ∬&≫	0	//ヤセ我慢してねぇで、
ヤセ我慢は戰戰	≪오기는 부ㄹㅣㄴ∬&≫	0	//ヤセ我慢はする
ヤセがまん戰戰	≪오기 부ㄹㅣㄴ∬&≫	0	//ヤセがまんしてねぇで、
ヤセがまんは戰戰	≪오기는 부ㄹㅣㄴ∬&≫	0	//ヤセがまんはする
悪乗り戰戰	≪덩달아 분위기 ㅌㅏㄴ∬&≫	0	//これから紹介する写真はちょっと悪ノリした愛すべきおバカさんたちです。
悪のり戰戰	≪덩달아 분위기 ㅌㅏㄴ∬&≫	0	//これから紹介する写真はちょっと悪ノリした愛すべきおバカさんたちです。
悪ノリ戰戰	≪덩달아 분위기 ㅌㅏㄴ∬&≫	0	//これから紹介する写真はちょっと悪ノリした愛すべきおバカさんたちです。
ノビ戰戰	≪기지개 ㅋㅕㄴ∬&≫	0	//ノビするよね。
お下げ戰戰	≪ㅊㅣ_ㅇㅜㄴ∬&≫	0	//お下げします。
お暇戰戰	≪ㄸㅓ_ㄴㅏㄴ∬&≫	0	//お暇しようかしら。
まっとう戰戰	≪완수&≫	0	//まっとうして。
腕組み戰戰	≪팔짱 ㄲㅣㄴ∬&≫	0	//腕組みする。
腕くみ戰戰	≪팔짱 ㄲㅣㄴ∬&≫	0	//腕組みする。
腕ぐみ戰戰	≪팔짱 ㄲㅣㄴ∬&≫	0	//渚は腕ぐみしたまま
彷彿と戰戰	≪방불케 &≫	0	//さながら焼きたてパンを彷彿とさせる弾力が、
マッチ戰戰	≪매치&≫	0	//慶司の服装とマッチさせることも重要！
愛想尽し戰戰	≪쌀쌀한 태도 취ㅎㅏㄴ∬&≫	0	//愛想尽しされる。
愛想尽かし戰戰	≪쌀쌀한 태도 취ㅎㅏㄴ∬&≫	0	//愛想尽かしされる。
愛想尽しを戰戰	≪쌀쌀한 태도를 취ㅎㅏㄴ∬&≫	0	//愛想尽しをする。
愛想尽かしを戰戰	≪쌀쌀한 태도를 취ㅎㅏㄴ∬&≫	0	//愛想尽かしをする。
あいそづかし戰戰	≪쌀쌀한 태도 취ㅎㅏㄴ∬&≫	0	//あいそづかしする。
あいそづかしを戰戰	≪쌀쌀한 태도를 취ㅎㅏㄴ∬&≫	0	//あいそづかしをする。
//▂2
お聞きは戰戰	≪듣기는 ㅎㅏㄴ∬&≫	0	//お聞きはしますが。
気づき戰戰	≪눈치ㅊㅐㄴ∬&≫	0	//お気づきする
気づきは戰戰	≪눈치는 ㅊㅐㄴ∬&≫	0	//お気づきはする
気づきも戰戰	≪눈치도 ㅊㅐㄴ∬&≫	0	//お気づきもする
気づきを戰戰	≪눈치를 ㅊㅐㄴ∬&≫	0	//お気づきをする
お連れ戰戰	≪동반&≫	0	//お連れする
お手伝い戰戰	≪ㄷㅗㅂㄴㅡㄴ∬&≫	0	//お手伝いいたします。
手伝い戰戰	≪ㄷㅗㅂㄴㅡㄴ∬&≫	0	//手伝いいたします。
お任せ戰戰	≪맡ㄱㅣㄴ∬&≫	0	//お任せ致します
お守り戰戰	≪수호&≫	0	//お守りしたいと思います。お守り致します。
//▂3
閑散と戰戰	≪한산ㅎㅏㄴ∬&≫	0	//閑散とする (かんさん) : 閑散としまくる。閑散としすぎる。閑散とされる。閑散となる。
ぐったりと戰戰	≪축 늘어ㅈㅣㄴ∬&≫	0	//ぐったりとする。ぐったりとなる。ぐったりとさせる。ぐったりとされる。ぐったりとなさる。ぐったりとして。
グッタリと戰戰	≪축 늘어ㅈㅣㄴ∬&≫	0	//グッタリとする。グッタリとなる。グッタリとさせる。グッタリとされる。グッタリとなさる。グッタリとして。
凛と戰戰	≪늠름ㅎㅏㄴ∬&≫	1	//凛とした (りん) : 凛としまくる。凛としすぎる。
//+.
早きに戰戰	너무 일러 시기를	0	//早きに失する。
遅きに戰戰	너무 늦어 시기를	0	//遅きに失したが。

//동사 + はする : "~기" 형태로 입력해야 함.
会い戰	만나기	1	//会いはする
聞き戰	(듣)묻기	1	//聞きはする
届き戰	닿기	1	//粗末な哀願は届きもしなかった。
載り戰	실리기	1	//新聞に載りでもしたら。
困り戰	곤란하기	1	//困りはしません。
わかり戰	알기	1	//わかりはする
分かり戰	알기	1	//分かりはする
勝て戰	이기기	1	//勝てはする
かすり戰	스치기	1	//そんな単調な攻撃ではかすりもしないし、
知り戰	알기	1	//知りもしない。
叶い戰	실현되기	1
厭い戰	싫어하기	1	//厭いはしない。
狂い戰	미치기	1	//厭いはしない。狂いなどしない。
戰あり戰	있기	1
戰有り戰	있기	1
//동사의 명사형
人食い梦名	식인	1	//人食い

//極まる 관련
愚かヶ	어리석기	1
痛快ヶ	통쾌하기	1
無礼ヶ	무례하기	1
狡獪ヶ	교활하기	1
危険ヶ	위험하기	1
不快ヶ	불쾌하기	1
巧妙ヶ	교묘하기	1
不都合ヶ	부적절하기	1
異常ヶ	이상하기	1

//ヶ를 붙인 と부사 (필터링)
ヶカクンと	달칵	0
ヶカクンッと	달칵	0
ヶキッと	홱	0
ヶキリッと	키릿	0
ヶキュッと	꽉	0
ヶキュンと	뜨끔	0
ヶキュンッと	뜨끔	0
ヶギョッと	오싹	0
ヶククッと	쿠쿡	0
ヶグイと	확	0	//そして艶やかな頬をグイと押さえつけ無理矢理に口を抉じ開ける
ヶグイッと	확	0
ヶグググッと	구구긋	0
ヶググッと	구긋	0
ヶグンッと	쭈욱	0
ヶグンッて	쭈욱	0
ヶグーンッと	쭈-욱	0
ヶグーンッて	쭈-욱	0	//グーンッて伸びてるなんて……太くて、硬くて…
ヶコクンと	끄덕	0
ヶサッと	휙	0
ヶサーッと	휙	0
ヶササッと	빨리	0
ヶサラッと	슬쩍	0
ヶサクッと	샥[ザクッと]	0
ヶザクッと	스윽[ザクッと]	0
ヶサクッて	샥[ザクッと]	0
ヶザクッて	스윽[ザクッて]	0
ヶシャンと	반듯이	0
ヶシャンッと	반듯이	0
ヶシンと	싸아[シンと]	0
ヶシンッと	싸아[シンッと]	0
ヶジッと	가만히	0
ヶジワッと	서서히	0
ヶスッと	슥	0
ヶズバッと	확실히	0
ヶソッと	살짝	0
ヶゾッと	섬칫	0
ヶツンと	찡	0
ヶツンッと	찡	0
ヶドッと	두둣	0
ヶドンと	펑	0
ヶドンッと	펑	0
ヶニッと	힐쭉	0
ヶパッと	팍	0
ヶハッと	확	0
ヶヒクンと	흠칫	0
ヶヒクンッと	흠칫	0
ヶピクンッと	꿈틀	0
ヶピクンと	꿈틀	0
ヶビビッと	찌릿	0
ヶピィンと	피잉	0
ヶピンと	핑	0
ヶピンッと	핑	0
ヶフッと	문득	0
ヶフラッと	훌쩍	0
ヶペタンと	풀썩	0
ヶペタンッと	풀썩	0
ヶボサッと	멍하니	0
ヶボソッと	살그머니	0
ヶボッと	멍하니	0
ヶポッと	화끈	0
ヶポォッと	화끈	0
ヶホワッと	둥실	0
ヶワザと	일부러	0
ヶワリと	생각보다	0
ヶじわっと	서서히	0	//庭の暖気が押し流されて、じわと冷気が身に沁みる。
ヶじわと	서서히	0	//庭の暖気が押し流されて、じわと冷気が身に沁みる。
ヶわっと	왓하고	0	//すると、わっと転校生の周りに輪ができる。
ヶぺろんと	날름	0	//自分の残り香を刻むようにぺろんと舐められ、正気を取り戻した俺は慌てて後ずさった。
ヶぺろんっと	날름	0
ヶじーんと	찌잉	0
ヶじーんっと	찌잉	0
ヶじーんて	찌잉	0
ヶじーんって	찌잉	0
ヶおおっと	어이쿠	0
ヶぷいと	홱	0	//ユエラはぷいと横を向いてしまう。
ヶばたんと	덜컹	0
ヶしんと	고요히	0
//
ヶガラリ	드르륵∥r	0
ヶガラリッ	드르륵∥r	0
ヶガブリ	덥썩∥r	0
ヶガブリッ	덥썩∥r	0
ヶキラリ	반짝∥r	0
ヶキラリッ	반짝∥r	0
ヶギクリ	움찔∥r	0
ヶギクリッ	움찔∥r	0
ヶギラリ	번쩍∥r	0
ヶギラリッ	번쩍∥r	0
ヶギロリ	번득∥r	0
ヶギロリッ	번득∥r	0
ヶグサリ	푸욱∥r	0
ヶグサリッ	푸욱∥r	0
ヶコクリ	끄덕∥r	0
ヶコクリッ	끄덕∥r	0
ヶゴクリ	꿀꺽∥r	0
ヶゴクリッ	꿀꺽∥r	0
ヶゴロリ	데구르르∥r	0
ヶゴロリッ	데구르르∥r	0
ヶジロリ	흘깃∥r	0
ヶジロリッ	흘깃∥r	0
ヶスルリ	스르륵∥r	0
ヶスルリッ	스르륵∥r	0
ヶズキリ	욱신∥r	0
ヶズキリッ	욱신∥r	0
ヶズシリ	묵직∥r	0
ヶズシリッ	묵직∥r	0
ヶズブリ	푸욱∥r	0
ヶズブリッ	푸욱∥r	0
ヶズラリ	주욱∥r	0
ヶズラリッ	주욱∥r	0
ヶズルリ	주르륵∥r	0
ヶズルリッ	주르륵∥r	0
ヶゾクリ	흠칫∥r	0
ヶゾクリッ	흠칫∥r	0
ヶゾワリ	섬칫∥r	0
ヶゾワリッ	섬칫∥r	0
ヶチクリ	따끔∥r	0
ヶチクリッ	따끔∥r	0
ヶチラリ	슬쩍∥r	0
ヶチラリッ	슬쩍∥r	0
ヶニコリ	생긋∥r	0
ヶニコリッ	생긋∥r	0
ヶニヤリ	힐쭉∥r	0
ヶニヤリッ	힐쭉∥r	0
ヶネットリ	끈적∥r	0
ヶネットリッ	끈적∥r	0
ヶヒラリ	훌쩍∥r	0
ヶヒラリッ	훌쩍∥r	0
ヶペコリ	꾸벅∥r	0
ヶペコリッ	꾸벅∥r	0
ヶベロリ	할짝∥r	0
ヶベロリッ	할짝∥r	0
ヶペロリ	낼름∥r	0
ヶペロリッ	낼름∥r	0
//+.
ミツヶドォルジテン	꿀도르 dict	1
