2014-04-04

修改
うち = 这里 //改为【我家(其中)】
ざっくり = 完全的 //改为副词【粗略】（副词、副词）
リア充 = 现实族 //改为【现充】
アーティファクト = 那个物品 //改为【人工制品】
アルカトラズ = ‘阿鲁卡托拉祖’ //改为【阿尔卡特拉斯】
けしからん = 岂有此理 //改为【不象话】
口を尖らせる = 撅起嘴 //改为（动词、不及物、过去式：口を尖らせた、没有宾语）
イイ = 可以 //改为【好】
時間潰す = 打发时间 //改为【消磨时间】

删除
クジ = 这边
あかり = ‘阿卡莉’
ヒート = ‘希德’
げな = 似地
ディー = ‘迪伊’
ニル = ‘妮露’
ねえ = 不（副词、副词）
ねぇ = 呐（名词、感叹词）
クスッ = 差劲（名词、名词）
マスカット = ‘玛丝卡朵’
ルヴァーナ = ‘鲁瓦纳’（地名、地名）
ネッタ = ‘涅她’
好き = 喜欢（连接词、连接词）
好き = 喜欢（副词、连接词）
好き = 喜欢（感叹词、感叹词）
好き = 喜欢（名词、副词）
好き = 喜欢（名词、形容词）
気にかかる = 在意
気にかける = 在意
肩を落とす = 垂头丧气
ことみ = 琴美
良かった = 太好了
よかった = 太好了
口を聞く = 斡旋
時間かける = 花费时间
時間かかる = 花费时间

添加
はしゃぐ = 喧闹 //（动词、不及物、没有宾语）
はしゃいじゃる = 喧闹 //（动词、不及物、过去式：はしゃいじゃった、没有宾语）
訊く = 问 //（动词、及物、过去式：訊いた、单宾）
いざとなると = 关键的时候 //（连接词、连接词）
レディー = 女士 //（名词、名词）
超能力者 = 超能力者 //（名词、名词）
詐欺師 = 欺诈师 //（名词、名词）
尻に敷かれる = 妻管严 //（动词、不及物、过去式：尻に敷かれた、没有宾语）
訳のわからない = 不明所以 //（形容词、形容词）
菩提樹 = 菩提树 //（名词、名词）
演じる = 扮演 //（动词、及物、过去式：演じた、单宾）
大丈夫そう = 没关系吗 //（名词、名词）
元気 = 精神 //（名词、名词）
元気そう = 看起来精神 //（名词、名词）
臆す = 畏惧 //（动词、不及物、没有宾语）
お大事に = 请多保重 //（名词、名词）
転げる = 滚转(摔倒) //（动词、不及物、过去式：転げた、没有宾语）
あらら = 啊啦啦 //（名词、名词）
灼ける = 灼热 //（动词、不及物、过去式：灼けた、没有宾语）
手を焼く = 感到棘手 //（动词、不及物、过去式：手を焼いた、没有宾语）
がばっと = 大量(猛)的 //（副词、副词）
そんなような = 像那样的 //（连接词、连接词）
猫質 = 猫质 //（名词、名词）
ちょびっと = 稍微 //（副词、副词）
頭が上がらない = 抬不起头来 //（形容词、形容词）
笑い転げる = 捧腹大笑 //（动词、不及物、过去式：笑い転げた、没有宾语）
封じる = 封住 //（动词、及物、过去式：封じた、单宾）
因縁を付ける = 找茬儿 //（动词、不及物、过去式：因縁を付けた、没有宾语）
にべもない = 冷冰冰的 //（形容词、形容词）
踵を返す = 折返 //（动词、不及物、没有宾语）
惚気る = 放闪光弹 //（动词、不及物、过去式：惚気た、没有宾语）
寝転がれる = 横卧 //（动词、不及物、过去式：寝転がれた、没有宾语）
ぽかっと = 整个(砰)地 //（副词、副词）
ぺたり = 轻轻 //（副词、副词）
艶かしい = 艳丽的 //（形容词、形容词）
ポッコリ = 鼓起 //（副词、副词）
ねぇねぇ = 呐呐 //（名词、名词）
などと = 等等 //（连接词、连接词）
かっこつける = 耍帅 //（动词、不及物、过去式：かっこつけた、没有宾语）
カッコつける = 装腔作势 //（动词、不及物、过去式：カッコつけた、没有宾语）
気合いを入れる = 鼓起干劲 //（动词、不及物、过去式：気合いを入れた、没有宾语）
攻略 = 攻略 //（名词、名词）
攻略する = 攻略 //（动词、及物、过去式：攻略した、单宾）
しゃがみ込む = 蹲下 //（动词、不及物、没有宾语）
いつか = 总有一天(某日) //（副词、副词）
いやぁ = 不 //（名词、名词）
心配ない = 不用担心 //（形容词、形容词）
噺 = 故事 //（名词、名词）
泊まる = 停泊 //（动词、不及物、过去式：泊また、没有宾语）
よけい = 多余 //（名词、名词）
よけい = 多余 //（副词、副词）
手を合わせる = 合掌 //（动词、不及物、过去式：手を合わせた、没有宾语）
止め = 停止 //（名词、名词）
ばっちい = 脏脏的 //（形容词、形容词）
顔を合わせる = 碰面 //（动词、不及物、过去式：顔を合わせた、没有宾语）
ですか = 吗 //（名词、名词）
ですよ = 哟 //（名词、名词）
っす = 的 //（名词、名词）
小姑 = 小姑 //（名词、名词）
託す = 托付 //（动词、及物、单宾）
何ですか = 什么啊 //（名词、名词）
なんだ = 什么 //（名词、名词）
想われる = 想的 //（动词、及物、过去式：想われた、单宾）
元気ですか = 精神吗 //（名词、名词）
後ろ指をさされる = 被暗中责骂 //（动词、不及物、过去式：後ろ指をさされた、没有宾语）
いまいち = 不怎么 //（副词、副词）
埋め込む = 埋入 //（动词、及物、单宾）
ピンキリ = 大小(好坏,高低) //（名词、名词）
戦隊 = 战队 //（名词、名词）
告る = 告白 //（动词、及物、过去式：告った、单宾）
よかったら = 可以的话 //（名词、名词）
良かったら = 可以的话 //（名词、名词）
遊び倒す = 疯玩 //（动词、及物、单宾）
再会 = 再会 //（名词、名词）
体操服 = 体操服 //（名词、名词）
が行っていい = 可以去 //（名词、名词）
って言うから = 说着 //（名词、名词）
不思議 = 不可思议 //（名词、名词）
もしてる = 也做 //（动词、不及物、过去式：もしてた、没有宾语）
報われる = 得到回报 //（动词、不及物、过去式：報われた、没有宾语）
訳が違う = 无法相比 //（动词、不及物、没有宾语）
虱潰し = 全面调查 //（名词、名词）
だったら = 那样的话 //（连接词、连接词）
目一杯 = 尽力 //（名词、名词）
しゃべる = 说 //（动词、两者都是、过去式：しゃべた、单宾）
喋る = 说 //（动词、两者都是、过去式：喋た、单宾）
落ち込む = 消沉 //（动词、不及物、没有宾语）
ずっと = 一直 //（副词、副词）
ずっと = 一直 //（感叹词、副词）
きっと = 一定 //（副词、副词）
気を配れる = 能注意 //（动词、不及物、过去式：気を配れた、没有宾语）
気が紛れる = 解闷 //（动词、不及物、过去式：気が紛れた、没有宾语）
気を紛らす = 解闷 //（动词、不及物、没有宾语）
一緒にいたかった = 想在一起 //（名词、名词）
ねちっこい = 纠缠不休 //（形容词、形容词）
パシる = 跑腿 //（动词、不及物、过去式：パシた、没有宾语）
アクセント = 口音(点缀) //（名词、名词）
吊るす = 吊 //（动词、及物、单宾）
包まる = 包在 //（动词、不及物、过去式：包まった、没有宾语）
ダサい = 差劲 //（形容词、形容词）
いじれる = 被玩弄 //（动词、及物、过去式：いじれた、单宾）
ヤバい = 不妙 //（形容词、形容词）
拒否られる = 被拒绝 //（动词、及物、过去式：拒否られた、单宾）
気を持たせる = 暗中示意 //（动词、不及物、过去式：気を持たせた、没有宾语）
じゃありません = 不是 //（名词、名词）
僻み = 偏见(嫉妒) //（名词、名词）
ハッスル = 干劲十足 //（名词、名词）
ぼったくる = 牟取暴利 //（动词、及物、过去式：ぼったくった、单宾）
滅多に = 很少 //（副词、副词）
滅多にない = 几乎没有 //（形容词、形容词）
シンボル = 象征 //（名词、名词）
ズルい = 狡猾 //（形容词、形容词）
寝返り = 翻身(背叛) //（名词、名词）
ぽい = 样子 //（名词、名词）
つまり = 就是说 //（副词、副词）
へたりこむ = 瘫倒 //（动词、不及物、没有宾语）
腫らす = 肿 //（动词、及物、单宾）